age,Computer,TV,Cellphone,Software,Frequency3,Monetary3,Monetary60
37,4,1,0,2,7,1607621.20656276,3220018.16223884
21,4,1,1,1,7,1654844.15638362,4792483.9219101
20,1,2,2,1,6,1884846.00667655,4681646.22619232
11,0,3,0,2,5,1415477.82762533,5861252.14096508
17,0,2,1,0,3,1669847.83548436,3914120.7031047996
33,3,2,2,0,7,1545481.23852585,4947146.20356515
31,0,3,2,5,10,2105460.07100934,6473999.40880908
28,0,2,1,6,9,1489749.89392392,5644315.25812264
19,1,2,2,7,12,2778741.22300153,9471111.08747988
31,6,3,0,6,15,2918166.52414713,2283950.86912228
33,4,1,1,4,10,1911474.13364375,8608557.63662782
36,1,0,1,4,6,1716291.01120753,4166897.98554586
27,3,1,1,1,6,1911924.39250468,6218210.68884069
23,3,2,1,5,11,1850448.16849163,5158172.7268640995
19,3,3,2,3,11,2524179.00577484,5134171.76140403
19,2,3,2,3,10,1747747.81068215,3291324.07951625
20,1,2,1,0,4,1568031.30474543,6070611.82135888
29,5,0,0,0,5,1790373.64486958,5269906.87978666
17,6,0,1,2,9,1539423.47205208,8443664.04702361
36,4,0,2,3,9,2121702.25139448,5381559.82334991
33,2,2,0,1,5,1488341.60756072,2662927.73792025
38,1,0,1,3,5,1726595.31124986,4509869.94814665
35,3,0,1,6,10,2009719.62158691,5975292.98210651
39,1,2,1,2,6,1693040.77533858,4275894.58805015
12,5,2,2,3,12,2238082.32891766,4644384.43695317
16,1,1,2,0,4,1418756.31018427,5007130.17063102
27,2,1,0,7,10,2513800.70450599,7209767.24199719
15,6,2,0,2,10,2478641.08107034,3995479.3939677
26,2,3,0,7,12,1799346.90910439,7364052.09843967
10,2,3,0,6,11,2193621.02127869,7036727.56528637
32,1,2,0,6,9,2213679.71941111,11995036.1560213
14,5,0,1,6,12,1986771.36833141,6187846.98372104
20,2,2,0,6,10,1816478.95948774,2883466.60180076
36,6,2,2,1,11,1827785.81633099,8377068.62410562
39,5,1,1,0,7,1686633.70012897,8556420.19599449
29,4,3,1,1,9,2351936.64047826,5801695.11671109
25,1,0,0,5,6,1078031.31930185,4894854.61631521
36,0,3,2,0,5,1208609.01373452,4613707.372585299
40,2,1,2,6,11,1601958.92879187,4648801.81159805
17,5,2,1,7,15,2349641.19961997,9370538.63716474
24,0,0,2,2,4,1368722.134035,3857336.39343777
39,4,3,2,1,10,1632321.16220332,2785261.18662458
16,1,0,0,6,7,2061339.93938262,3590067.30986512
24,3,2,1,0,6,1500226.89287127,4810279.90244606
36,0,2,1,4,7,1666278.10344668,5075364.38810938
22,2,3,1,2,8,2120843.30590766,5621061.60847736
34,5,3,2,4,14,2197878.4687344,4751482.55047325
29,5,2,0,1,8,2003868.24765226,5370991.00685036
39,2,0,2,7,11,2896951.21626092,7408193.28523212
30,5,2,0,6,13,1722693.52212886,6151385.61247538
22,3,2,2,5,12,1970098.65463045,9303252.90231594
38,5,1,1,7,14,1701334.89226567,8871245.60574031
23,0,0,2,5,7,1752469.47854927,3599335.20455776
38,5,1,0,7,13,1669160.86653373,3736567.60250173
26,3,2,2,6,13,2760970.09548374,6011270.88564221
31,0,2,0,7,9,2047832.95376096,8055926.44799169
33,6,3,1,3,13,2604499.37896494,4958875.43373053
11,6,0,0,5,11,1484695.91040987,8190188.53397534
40,4,3,2,7,16,2822925.89447133,8014635.61568015
23,1,2,1,7,11,1954696.46753781,7212393.27334233
19,1,1,0,6,8,1993854.31376323,5972298.75752649
28,0,3,0,0,3,1135011.03916378,4490353.6442843
39,1,0,1,7,9,1662954.80804964,5563821.20820005
16,2,0,1,3,6,2004691.09420333,3877873.5579436007
20,5,0,1,6,12,2447487.57029536,11720937.825732699
38,6,3,1,1,11,1829489.5218816001,7269549.71416939
38,3,3,0,5,11,1967651.15405923,7745848.26167466
40,0,1,2,5,8,2082375.86838615,6614601.57106029
18,1,2,0,6,9,2613495.52034119,8111380.60941518
17,6,1,1,5,13,2389184.22117153,8243145.58486059
14,0,0,2,6,8,2325642.68268831,7572783.47606348
31,1,2,2,6,11,1688344.76978996,7201213.05903665
39,6,2,0,2,10,1969591.92265568,5717903.51093974
13,4,2,1,5,12,2249209.78339978,5785191.0165117
10,2,2,2,0,6,1665478.79445464,4509119.23692665
23,2,3,0,3,8,1942539.31160016,5073921.22652598
19,2,3,0,4,9,2508268.92971054,5662379.64079492
30,6,3,2,0,11,2116936.73939109,4954155.93756701
36,2,3,2,0,7,1850380.13841235,6174984.47610212
13,1,2,2,1,6,1637195.44153557,4112908.34208396
37,5,3,2,4,14,3191091.62503795,8534058.04236687
33,0,1,0,3,4,1264111.98583112,2813580.38552091
11,6,3,1,7,17,2528482.55398381,12919955.943974301
10,1,3,0,2,6,1188805.68934259,4513720.69996627
18,6,2,1,6,15,3364342.92466724,8380114.80961107
17,5,1,1,7,14,2117116.61515564,4998813.65874386
32,1,2,0,5,8,2089424.41445831,3251003.67420654
39,5,0,1,1,7,2102796.04018719,7165349.08421999
22,2,0,1,6,9,1904847.5839189,7652031.88418359
20,6,2,0,3,11,1896314.04315695,6785828.93580513
14,4,3,2,5,14,2710776.74580872,8574601.82912454
19,4,0,2,6,12,1725445.73047199,7361092.26016124
17,1,0,0,7,8,2233738.31700916,8019173.27396934
10,6,0,1,0,7,1430679.66844427,8336784.17088382
13,0,3,0,1,4,1207921.53733451,4071861.932034
26,5,1,1,2,9,2151319.02101117,9296225.07785995
25,3,2,1,6,12,2370954.14369116,5714872.23126001
31,5,1,2,5,13,2801700.79041982,6915799.3532080995
29,1,2,0,1,4,1142064.01631007,5339859.70258657
17,4,2,2,6,14,1844910.53636923,6255325.25109339
31,2,3,0,2,7,1285690.00453099,3819100.06183025
23,1,3,1,5,10,2060101.07911802,5266009.44704537
25,5,1,2,4,12,2131507.5275187,6819827.03497156
35,2,1,2,4,9,2402424.15062378,4389670.22726905
15,4,1,0,6,11,2188196.48402925,9295590.16940288
15,1,3,2,1,7,2191587.46017344,7141477.04429811
33,3,0,0,0,3,942771.0037820359,5363833.47894686
26,5,0,1,7,13,2144809.82910202,5007746.65565355
30,1,2,0,0,3,1012596.47891822,3276277.07975809
31,0,0,1,5,6,2187835.4056427,7610110.78978294
33,6,2,1,3,12,2437297.3194499,8701473.45053335
21,5,1,2,6,14,1876446.08621251,5731363.97989915
19,5,1,0,0,6,1956393.39264845,6154708.98366256
17,4,2,2,5,13,1773736.7026634,9966398.39366848
22,4,3,2,4,13,1585346.14672821,5199931.23735918
26,1,2,1,3,7,1962003.36827255,6725526.35601099
15,1,0,0,1,2,919136.735949068,3243380.46079686
40,5,0,2,1,8,1977392.84765237,5489911.1393818
16,1,1,1,7,10,2071514.70621979,3584481.93422042
14,4,3,2,7,16,2830868.95941199,7482579.71344215
32,0,2,0,6,8,2129578.1394292,3746518.52667818
37,3,1,2,6,12,2265013.9597827997,4937884.12002318
34,2,2,0,4,8,1429669.32706177,1572267.11137491
19,4,3,1,4,12,2074028.54430219,5438535.29362702
38,6,2,0,2,10,1788048.08698537,8500616.39821974
34,2,3,1,3,9,1395010.1449231,7694107.61579238
10,6,1,1,0,8,1915601.456093,6635944.09845778
36,3,2,1,4,10,1997857.60987423,6280991.75411767
12,5,3,0,7,15,3045849.01295742,8545570.03169252
33,0,0,0,3,3,1758805.6050511003,3899191.1275431
10,6,1,2,3,12,2286622.91650015,7333023.06587212
15,5,2,1,4,12,2615274.57884537,6275622.1037161
13,5,3,0,7,15,1879326.45641621,12757676.0017526
35,5,2,2,4,13,1586814.1067801001,5253360.18884774
30,6,1,2,0,9,1718291.10463554,3152680.43973981
37,6,1,0,3,10,2236805.62597808,7223267.02160485
30,2,3,2,7,14,1400935.24995328,10132199.3561089
21,2,0,2,4,8,1310651.92633778,6592823.649991599
10,1,0,0,6,7,1550270.04052578,5266253.96652205
36,0,0,1,1,2,1033490.19649947,2573856.19757456
30,3,3,2,3,11,2170811.20790055,6831367.46880021
35,0,1,1,0,2,1375454.72920899,4494336.90506352
19,5,2,2,2,11,2610219.79712422,6063172.75314777
40,5,3,1,7,16,2295034.00628411,9715974.46232592
28,0,3,1,2,6,1678508.95821486,6494474.94564566
29,4,2,2,7,15,1416065.84267661,7985537.07108641
25,3,1,1,4,9,1668722.2632745001,6437111.16188939
27,0,2,1,5,8,1556508.31792934,7263256.13242075
11,2,0,1,5,8,1957285.59684054,5882404.64023608
11,1,2,2,6,11,2207049.71198289,9014337.50425973
16,3,0,1,3,7,1665925.1815273,2479277.74340725
38,1,2,2,3,8,1827961.76630575,4930731.80249985
33,3,2,2,2,9,1974134.5756586003,4293319.97948806
24,6,1,2,2,11,2313146.74127457,5327248.08489176
30,2,3,0,5,10,1711772.69185263,6275868.51452945
38,3,3,2,6,14,2915964.11436282,7689439.68064965
28,6,1,2,2,11,3090056.54067245,4765922.29029686
35,6,3,1,6,16,2744841.93946232,6541218.48860482
21,1,1,0,0,2,969176.349118354,4764909.50345581
13,3,1,2,6,12,1954954.16469379,4532933.35434793
17,4,1,1,2,8,1407829.79108179,4998644.38144042
22,6,1,1,7,15,3089040.79967001,4637633.95646437
11,1,0,2,5,8,1756435.80055624,5985817.74489514
14,0,0,2,7,9,1630231.30056556,4460459.75497922
34,0,3,0,7,10,2203517.28087956,7167328.33033713
21,4,3,0,3,10,2156077.44370273,3068799.76681256
30,4,1,1,0,6,1567131.23957188,3520195.33031492
19,1,0,0,6,7,2179850.17670474,3163137.11716413
21,4,3,1,5,13,2206977.66296809,5908231.94082146
17,0,0,2,6,8,1504204.1662264,6268148.68637156
20,5,1,1,0,7,1538017.07437507,1989601.64692844
36,2,1,1,4,8,1809988.62309599,7891100.57393557
32,1,1,2,6,10,2217801.26547347,4293162.32735302
11,5,1,2,6,14,2668675.94547461,5732893.12889735
28,4,0,0,3,7,1517683.36675813,2259579.30931039
11,1,0,0,0,1,885736.5088789591,5837035.0929291
21,3,1,1,1,6,1799286.91674709,7017892.07557686
31,4,2,2,1,9,2154640.5046846,4524077.41730356
14,5,1,2,2,10,1762884.5240298,3986778.63747041
34,5,0,2,1,8,1692136.70532012,4610666.63434919
20,2,0,1,3,6,1518778.34333824,4108456.00116387
36,4,2,1,0,7,1861152.46558065,5288424.20481687
35,5,0,2,2,9,1825649.49812556,5677421.3675628
20,6,2,1,7,16,2365876.64208286,8776842.5690817
24,0,2,2,3,7,1921329.29896573,5214368.81836592
40,6,0,2,3,11,2696845.21383424,6377562.3809963
22,2,2,1,6,11,2492927.00773904,4438637.3762729
27,4,3,0,7,14,2054395.80344971,7761878.06541419
13,4,1,0,1,6,1735795.56816104,4588820.9998876
12,3,3,1,0,7,1828403.73234935,5771994.44295773
36,1,1,2,6,10,1904583.56220256,7026316.42267586
21,1,3,0,0,4,1465633.44218948,3826764.7511787997
19,6,0,0,1,7,1569610.55472973,5405513.21694394
31,5,2,2,3,12,1271532.22941593,6141902.00551531
10,1,1,2,6,10,1910269.2557354,3488938.04278823
34,6,3,0,0,9,1829060.76424532,5611149.69805276
17,2,0,2,3,7,1985616.19715833,3888171.59415259
27,1,2,1,5,9,1884168.64972955,4409350.26635622
40,6,2,2,0,10,1996876.22104953,6261212.43535906
14,5,2,0,4,11,1850860.85197431,5183167.39641506
34,0,0,0,6,6,1892670.71942524,6052832.33128562
34,2,1,1,1,5,1081830.35616708,2695322.65443209
29,0,3,1,5,9,2067474.39364458,6993686.53733631
26,4,3,1,4,12,2442206.0218203,5677503.12980324
33,2,0,1,3,6,1695646.43152319,4319984.66909178
29,3,1,0,3,7,2150394.32674097,3870261.31474558
10,1,0,2,4,7,1603087.9959338002,4547417.19374328
22,4,0,1,7,12,2173682.10462127,9429492.28520667
39,5,2,1,0,8,1837153.61703734,5310603.36733851
39,6,2,1,5,14,2066458.28329855,10741582.5686232
34,3,2,2,3,10,2327416.54691856,7423730.75269443
29,1,2,0,5,8,1748656.77871975,6650798.79448455
36,1,2,0,1,4,1593310.76068109,1972147.93425307
22,6,0,1,5,12,2143756.24433439,6881681.50859199
17,4,2,2,5,13,1287303.00273966,5857298.50129523
34,6,3,1,2,12,1554164.87039083,5873052.00294491
35,4,3,1,3,11,2305067.8437862997,4183583.32785947
31,2,1,2,5,10,1226597.61672233,6360087.28479668
25,4,0,2,7,13,2922943.81328275,8072941.28861884
38,4,1,1,5,11,2818592.71326067,6915789.80572304
19,4,0,2,6,12,2559843.25684376,6729463.21536229
39,3,0,1,2,6,1996936.79298087,7211527.81072097
36,5,2,2,1,10,2185487.81079959,8609754.80663558
25,6,0,2,0,8,1927503.93640827,2010437.53459914
33,5,3,1,5,14,2332424.54325167,7674135.14661169
21,4,1,0,3,8,1776803.61625966,2307465.58070651
29,4,3,1,0,8,2262247.0894955,6087226.57393181
13,5,3,0,6,14,1840371.24604342,5803669.16022103
10,4,2,1,6,13,2404885.44174566,3480060.38900691
31,0,3,0,6,9,2083413.15046329,5164528.8917761
20,0,3,0,3,6,1541484.73536354,2593539.13405616
27,1,0,1,3,5,1287078.89721677,5038891.16092399
17,4,3,1,6,14,2363713.21962926,6518287.97175235
28,3,0,1,5,9,1422790.74773237,3905204.02536577
19,6,1,1,5,13,2425089.51635322,4451462.38426745
34,3,1,2,5,11,1794412.31898614,4531581.28411763
29,3,0,2,7,12,2206718.79232186,5364871.66016614
29,3,0,1,2,6,1707229.32426965,6276903.652545501
26,3,3,1,3,10,2553542.59641442,2628950.65331615
36,4,3,1,0,8,2100907.03574842,5038696.86278485
21,0,2,0,0,2,1156087.96937034,2855766.56484943
39,5,3,2,6,16,1980860.27011897,9060410.59185095
39,2,0,1,1,4,1422132.35517172,4581054.0821822
29,6,3,2,0,11,2005814.90351207,9426145.34631427
30,2,2,0,7,11,1995756.73546998,6455576.82383441
39,5,2,0,7,14,2109546.13123587,10047540.8113361
19,6,1,2,5,14,2147802.25142774,12528343.4330631
32,2,0,0,2,4,966638.97959685,2759715.00682497
12,0,0,1,4,5,1900875.43156465,3639187.20100313
37,2,3,1,7,13,2008011.97438146,6357352.32586969
32,6,2,0,4,12,2645618.63797931,8005592.09152794
35,5,3,1,7,16,2815181.78343509,7258573.78460782
16,0,2,0,1,3,1191377.82443315,4748259.47369412
11,2,0,0,2,4,1441018.60697775,4457658.93320685
14,6,0,0,5,11,1569778.53660416,6003750.81368772
30,6,0,0,5,11,1746293.53212128,4012266.93428746
10,4,2,0,1,7,2092691.22039561,4623625.48261552
19,0,2,1,0,3,1159689.80754992,1595941.24402077
23,6,3,1,2,12,2240652.82639416,10910371.343667401
19,2,0,0,5,7,1208372.09737096,3618415.36984826
34,1,1,1,1,4,1298182.08522796,1914941.0264052
20,4,0,1,1,6,1360793.67621405,5098671.57218312
23,5,1,2,0,8,1933802.61941482,2129062.74683748
34,1,1,1,4,7,2013612.52500476,5743905.32190239
19,2,0,2,7,11,2252662.76670045,5617605.23481909
19,3,3,0,7,13,2386003.57691454,10532494.2318032
21,6,3,0,6,15,3044528.46057163,7516650.74689983
20,3,1,1,6,11,2786724.24379402,8720200.25519519
29,3,2,2,0,7,2123911.60442485,2437629.99869836
25,3,1,0,1,5,1440488.47020224,5245556.21676491
40,4,0,1,2,7,1753092.14733604,7000362.17620692
40,6,3,0,1,10,1230800.88788899,4995895.52507782
15,1,0,1,1,3,1557386.2836857,5065594.87153093
34,3,1,2,4,10,2240963.19694348,6136928.36856194
15,0,3,1,4,8,1732276.31387988,7672648.26220807
30,5,1,1,7,14,2320357.67664897,5994407.75167897
22,3,3,1,1,8,1951775.75581306,5807527.27760035
10,6,3,1,6,16,2578603.73797588,9271829.53232886
25,0,2,1,6,9,1657470.31804648,6013846.45746931
28,0,1,1,1,3,1812160.07951053,3698740.28711981
32,2,2,1,7,12,2200310.8188195997,7998557.29562019
24,3,0,2,0,5,1610665.58181997,5260050.11342648
22,0,2,0,3,5,1547690.11125594,3891526.81886953
26,2,0,0,7,9,2046181.10765007,5726282.56739678
31,3,0,1,4,8,1751679.27104933,3082102.23087789
15,0,1,2,5,8,2263507.48268554,3583904.3294865
19,4,1,1,6,12,1945801.78597341,5147734.07962797
38,0,1,2,6,9,2192249.96891116,2400158.87824318
37,2,3,1,7,13,2358119.23296297,7165975.49227556
40,6,0,1,4,11,1506450.0326642,5793801.86276803
11,0,3,0,1,4,962361.691701474,3201024.68968114
32,6,2,1,5,14,2234964.21813432,7144922.50127391
36,1,1,0,1,3,1420577.79369748,6496484.76040691
11,2,3,0,6,11,2152718.29426618,6309837.37512722
17,0,1,0,3,4,1513044.35484564,561255.733187265
25,0,3,1,0,4,1488120.24076893,4200355.15947024
18,3,0,2,4,9,2374447.93610095,2799693.72499519
33,2,2,0,6,10,1644560.44536793,6354091.26780376
15,2,1,0,6,9,1416592.23331605,4577717.18034624
21,5,2,2,0,9,1970757.43240767,10145848.148792999
30,1,3,0,7,11,1759337.17896397,5556591.97914473
15,4,0,1,3,8,2378030.7856881,6864626.98156267
37,0,1,1,4,6,1629011.95065635,3138018.36195108
27,6,3,0,7,16,2331463.54411702,9188660.25709247
18,6,0,1,7,14,1912266.75009592,10999605.4756312
19,2,3,1,4,10,1950250.23326692,5790060.10729317
16,3,0,2,4,9,2020213.58625986,3539467.99973134
17,2,3,0,0,5,1339723.13079572,4614463.43570688
20,0,2,2,3,7,1519899.09121396,2814376.40254992
27,0,1,0,0,1,1151555.76278153,2561196.44031366
22,2,3,1,4,10,1354905.47885327,9615925.63505326
39,6,3,0,4,13,1383969.60172622,8415458.08378204
21,5,0,0,4,9,2055783.99209447,8497417.90752945
30,4,0,1,1,6,1479551.24504975,6532154.80526309
39,5,0,0,0,5,1357085.72590292,1440887.52538334
38,4,3,2,2,11,2277090.20454874,4355525.69907331
21,2,2,1,0,5,1901673.57556366,6483813.77318088
17,5,0,2,1,8,2101664.11969332,1749904.27743914
23,5,1,1,5,12,2238726.83669599,8101053.17355268
21,6,1,1,1,9,2173127.52855485,2824903.53858138
38,1,0,1,7,9,1979356.6601904,7040963.472650399
30,2,3,0,2,7,1474943.48676964,3715606.01218396
28,6,1,2,6,15,2388558.44478203,5450774.23776827
30,4,0,2,3,9,1508746.17243619,6954813.63103733
31,5,1,1,7,14,2662762.86087444,9955802.42412635
10,3,0,0,0,3,1523856.50136349,4561857.80893708
32,4,2,0,5,11,2416885.0823047995,6136208.77401452
23,5,3,1,4,13,3053586.64475154,7432203.86950905
34,1,1,1,6,9,1901053.99845266,6691974.69830762
38,6,1,2,6,15,1892486.51989431,4105052.46952898
19,6,1,1,5,13,2403841.35561974,6110892.33178003
36,5,0,1,5,11,2278312.95229182,1979977.00998477
23,4,0,1,4,9,2032460.08118224,4418018.62477574
21,6,0,0,0,6,1300214.26804319,4884950.99548542
31,6,0,2,7,15,2471792.01931885,8921720.10717764
22,4,2,0,1,7,1359082.79013292,6040187.49650731
37,5,0,0,2,7,1931414.09837258,6486664.35627611
30,4,2,0,7,13,2490117.33605955,9968966.15191144
15,4,0,1,5,10,2059697.57855604,4038454.05016145
27,6,1,2,6,15,1482050.75967501,6169674.20105147
32,1,2,0,2,5,1909484.17388246,4222203.00562773
14,3,1,0,0,4,1745102.66148767,4143061.11470999
21,5,0,0,0,5,1907404.82027025,5039998.94550283
40,5,0,0,4,9,2506871.93952698,6745060.20897762
13,0,3,2,5,10,1977853.07350601,6211134.4108377
39,2,2,0,5,9,1660984.29378554,5619185.27478268
12,0,2,0,0,2,1174988.86283201,4596582.61892149
33,0,3,0,7,10,1489541.49136166,5042116.03404927
28,1,1,0,4,6,1308463.46265325,5302608.27965422
17,1,3,1,3,8,1781286.48793937,5401748.17233313
31,1,0,1,6,8,1575869.2739517,6864268.77440411
24,6,1,1,3,11,2675892.64068657,7497815.40369167
39,3,3,2,5,13,2016978.46281201,9605300.06496051
28,3,0,2,6,11,1712851.61230727,7889094.78040608
27,1,0,0,1,2,1122242.27982138,3699105.08099948
32,5,0,1,5,11,2010731.62035554,5658848.18612409
33,5,2,1,5,13,2245538.36635228,10527568.269113401
17,5,2,0,0,7,2182448.25612825,2232945.80051589
10,2,1,0,5,8,1893529.31236651,4088514.38432843
27,2,2,1,4,9,1495409.64414445,5943050.8800672
28,1,0,0,7,8,1995339.58427249,8327399.19802966
31,5,3,0,3,11,2091073.27102283,2837755.3267403
29,4,2,0,1,7,2208117.69520024,6953342.42286791
31,3,1,0,7,11,1578348.90604333,8175584.80274579
31,0,0,2,0,2,1024674.45221119,2870796.99617038
19,5,2,0,3,10,1677657.55616334,9041937.87125384
21,2,2,1,5,10,1905840.49666144,4519861.63064599
11,4,1,1,5,11,2580238.42478468,9376454.95961767
23,2,1,0,2,5,1618195.65512478,4686745.65685221
19,1,0,0,7,8,1963632.76958548,4300260.52913303
40,2,1,1,6,10,2306307.51788274,5506197.66429036
28,5,1,1,3,10,1877866.79727805,5399521.40797589
20,0,3,0,0,3,1458610.25755123,3246931.8937302004
31,2,1,1,6,10,1589986.26482867,6299176.30087964
25,2,2,1,3,8,1692006.15499432,5313305.17743401
29,6,0,1,5,12,2020338.54616822,4500727.81307484
25,6,1,2,5,14,2428852.2783132005,4502636.53279982
37,3,3,2,1,9,1770231.70992025,3289123.75237585
20,4,0,1,4,9,1719339.01301834,4264140.69957521
16,4,1,2,3,10,1494367.29813702,6148812.04066381
20,2,0,1,5,8,1921869.60443598,4828378.91492269
19,2,2,1,0,5,1953321.73367256,5948617.573389701
10,4,2,2,4,12,2406103.29503392,8937147.291323802
30,1,3,1,1,6,1092952.49079982,4574203.43085519
18,0,3,0,5,8,1993981.53666003,7072986.0557261
11,0,2,0,7,9,1313796.96762616,3527627.18058651
30,0,2,2,4,8,1841484.11980351,5949591.54953943
14,5,3,0,0,8,1855508.58439308,6066621.76642104
39,4,2,1,0,7,1860834.7566417,2516416.08979715
16,3,0,1,5,9,2085012.15776763,4933132.28646776
11,5,0,0,3,8,2162123.86854691,4754724.1531911
35,3,3,0,4,10,1935998.62547113,5686893.56800952
13,2,2,0,2,6,952545.715364257,4432373.70891777
14,2,0,1,5,8,1309813.82559637,5783752.86251502
15,5,1,2,0,8,1787171.14259396,5235418.63898924
36,4,2,2,3,11,2029639.0195988999,4892362.81198981
22,6,3,0,7,16,2511180.04133246,6678556.515759599
34,5,1,2,0,8,1882269.71732833,3010750.94600699
34,3,2,0,1,6,1821794.96539576,8509857.96826931
34,5,0,0,7,12,2336165.22977712,5805667.13470635
12,6,2,1,1,10,1782869.02063613,4637163.6149338
23,6,2,2,2,12,1338907.88628962,5959798.4079046
15,5,0,0,0,5,1285921.93345488,2901309.19837017
31,0,0,0,5,5,1521567.80031872,3575601.39157165
15,2,2,0,0,4,1351471.02860261,4974076.4773345
28,0,2,1,2,5,1314268.94688486,5266581.77754624
14,4,1,0,0,5,1784872.37856088,7893830.2140103
26,0,3,1,5,9,2508425.20665886,8204558.648327099
28,4,0,2,1,7,1935458.01342763,6525777.38467185
26,1,0,1,2,4,1618859.69844698,4383800.57506792
29,0,2,0,2,4,1540013.09609714,5755137.56654593
30,1,1,1,4,7,1814729.7489764,5513723.95998542
38,0,3,1,6,10,1844795.55186766,6260614.00560201
16,3,0,1,3,7,1967913.26192574,6280145.42780666
29,2,3,0,0,5,1568857.42995044,4025213.89329965
17,0,2,1,3,6,1639559.42346369,4905701.04428661
35,4,2,1,0,7,1697295.33583838,6257996.34166864
22,3,1,2,7,13,1892405.20220668,6508109.26821646
40,1,0,1,3,5,1355196.23857201,5159825.51836969
23,1,2,1,0,4,1422185.64055648,5296876.93412599
38,5,3,1,7,16,2020986.11012674,9956902.44214798
31,6,3,0,1,10,1776593.00788465,6211398.16954475
10,1,2,0,1,4,1269099.05404549,2946659.50761869
19,6,1,2,7,16,2765564.49813933,6045831.07699591
23,1,3,1,1,6,1760625.2396156997,3974696.19152408
35,3,2,2,4,11,1888083.87616454,6700314.72696762
21,0,0,0,1,1,1008103.74542363,4698028.94535057
30,5,3,1,2,11,2375018.97574803,5129445.86476699
13,4,3,1,1,9,1939212.80398357,7252503.9889378995
14,5,3,1,0,9,1728341.7523261001,7962672.84216024
36,4,3,1,4,12,1772588.90542239,7027587.77105204
35,2,2,1,7,12,2263106.88544466,6177920.97908771
26,5,0,1,3,9,2757386.66832348,5642423.05919956
29,0,1,0,2,3,1789195.09871779,3839162.10201896
30,5,2,0,7,14,1815873.68278916,5932911.03290216
36,5,0,0,4,9,2249490.8275479,6643171.46019261
36,3,1,2,2,8,1732878.97291391,8948951.54444472
38,6,0,2,3,11,1759849.55212288,11078029.95489
29,0,1,0,5,6,1591725.227282,6402820.21682746
19,2,2,1,4,9,1622472.58989311,2219173.25544131
26,5,3,0,2,10,2020546.71797277,9396415.66123557
28,1,0,2,6,9,1794097.96448822,4166023.55816226
21,3,1,2,7,13,2275104.19241997,5696307.53959784
40,1,1,1,7,10,1908898.0289454,10762391.7736705
36,4,2,2,1,9,2198797.79695731,4679700.69960066
33,2,3,2,1,8,1890627.77266221,6473046.8356579
21,6,2,2,1,11,2335176.41269008,4256733.26668317
34,5,3,1,3,12,1962085.59581977,10534721.5675715
17,1,0,0,3,4,1404443.98076583,3946740.12106308
39,2,2,2,6,12,2056469.61007145,6758051.91173017
27,3,2,0,6,11,2817280.88147803,7295529.93444488
32,3,3,2,1,9,1976396.69036109,7772202.72083977
31,3,1,0,2,6,1896891.4895251999,3421218.74039005
13,5,0,0,7,12,2565872.76934815,8434025.52662461
13,2,3,2,6,13,2200643.86228649,8660557.1809106
20,6,2,0,5,13,2009393.83464406,5644051.39643604
15,0,2,1,0,3,1172507.65663001,1912502.46081738
26,5,3,1,3,12,1944003.79498839,4805329.86175385
33,5,1,1,1,8,2051880.18523939,6459058.92991719
31,3,3,2,1,9,1839760.37829174,5132806.91559934
37,2,2,2,2,8,2072273.8594923,5884082.13769541
24,0,3,0,5,8,2208318.36078943,4430795.49795817
28,0,0,0,7,7,1628055.54996819,4655662.92960564
31,2,3,0,5,10,1572585.12677325,4864070.65613999
35,4,1,2,7,14,2841264.17754738,5562830.87487841
19,5,3,0,4,12,1753942.3561128003,7362981.91767647
30,0,2,0,0,2,1217849.25061499,2613985.32733367
37,0,2,0,5,7,1755742.59721548,3864371.5953138
36,0,2,1,5,8,1570206.45051558,8726492.23142448
40,4,3,0,2,9,1652772.75311695,6451955.93138338
23,6,0,1,5,12,2168080.35781374,6292652.99849217
15,0,2,0,4,6,1453832.20109738,5006497.46861633
29,3,3,1,6,13,2514349.69786206,8299860.16102601
27,1,3,2,0,6,1264878.26640876,6346675.03699188
14,4,3,1,6,14,2473661.42179887,5300778.51055289
34,5,0,1,1,7,1937100.12979301,4670121.88060569
33,6,1,1,3,11,2204158.49610605,5585858.60929654
17,1,0,0,0,1,1112615.50805651,5373327.87761316
34,6,2,1,7,16,2694654.10245063,3851705.32831281
37,4,0,0,5,9,1446909.76946148,5144718.16951774
11,6,1,2,0,9,1787810.58249315,5530276.96281043
25,2,2,0,1,5,1574469.76389492,4806484.87254064
22,4,2,0,6,12,2482412.99165967,7576241.22132171
12,4,3,1,0,8,1296465.80915177,4744852.61100319
29,4,1,1,4,10,2450518.33516736,6863674.5037161
24,3,0,2,6,11,2511593.4376177,7155854.52255082
20,2,0,2,0,4,1043289.13551967,5234858.80264985
25,5,0,1,4,10,2026973.59368251,5202457.9304567
31,3,1,2,3,9,2054012.13200703,6306617.09110448
17,3,2,1,1,7,1850890.36853407,6098453.63161285
11,0,1,1,5,7,1795084.83586594,3274068.52716486
25,3,1,1,7,12,2829452.35102623,6307486.3760292
25,3,0,2,5,10,1968437.11931393,6541164.75376999
28,1,3,1,5,10,1733146.19049276,10039623.9092061
34,2,3,0,4,9,1835653.90194743,4853782.81695169
30,3,0,1,0,4,1253611.22426935,4645070.67903844
18,6,1,0,3,10,1919292.5560111,5385308.54628317
16,1,3,2,1,7,1684369.15107146,4214634.99342664
10,3,1,2,1,7,1367162.32200457,2048573.85352415
18,6,1,1,2,10,1666124.05576338,8345465.30652802
26,6,2,2,1,11,1854749.84718333,6328184.87549101
15,4,2,1,5,12,2213531.48209628,6038703.36561288
36,4,1,1,7,13,2095907.3777899,7330132.387606501
34,1,0,1,7,9,2491902.79624716,3999222.16025133
30,4,3,0,1,8,1739993.76955003,5037331.95769932
32,1,0,2,5,8,1659041.80552692,6840559.63309847
28,3,3,2,3,11,1835977.21256007,7988983.47898718
18,5,3,0,2,10,2694868.12917109,6446732.73368074
36,6,0,0,5,11,1673382.28159878,3442370.08583849
20,0,3,0,6,9,2589200.505563,5694856.28387998
19,0,1,0,6,7,1472791.15888872,7038536.69579529
29,3,0,1,2,6,1749315.70044663,1007317.56894449
11,2,0,2,1,5,1311683.33849114,373969.356588074
32,0,3,1,5,9,2385063.07853527,4854481.67157104
23,5,1,1,4,11,2241739.09659413,8328219.08643655
25,0,3,1,3,7,1581636.78042774,3178950.29679436
20,3,2,0,4,9,2167849.79217633,8440568.23687566
25,3,0,0,5,8,1534313.50999859,5022299.82335592
38,3,3,1,6,13,2865449.15926989,7730477.11229838
16,0,3,2,6,11,2191961.45887785,4135794.92390852
40,1,0,2,1,4,1424394.26235643,4162649.12243097
26,1,0,2,2,5,1398450.32717146,4910761.87455792
39,0,3,1,1,5,1244821.40448204,4975805.79089148
23,0,2,2,2,6,1880588.68181919,5465826.15605752
14,0,3,1,0,4,1218229.45060211,1893965.99485313
23,5,2,1,4,12,1698665.72140558,5061237.94370263
27,5,0,1,2,8,2030456.71685282,6618205.03029648
12,0,3,0,2,5,1403367.2563393998,366733.71301993396
14,0,1,2,4,7,1779095.13399344,7666886.70749442
35,6,3,1,5,15,2900405.65050946,4194539.22532913
36,4,0,0,7,11,1911166.71996593,8719009.44681089
31,5,3,2,1,11,2167025.32331186,5400153.06237879
21,1,1,2,7,11,2288998.91616395,5683173.43778745
27,3,0,2,0,5,1485514.06467379,5007049.87400098
36,6,3,0,7,16,2123003.77266734,7600072.8306255005
34,0,2,2,0,4,1348756.15964857,3262903.76783031
11,5,3,0,0,8,2184299.52283908,3415205.31523213
37,3,3,0,2,8,1671723.00514286,4162476.16047207
26,6,3,0,3,12,2001423.54763567,7458042.21480057
26,0,1,2,5,8,2010092.14173125,4952623.96852507
22,0,2,1,1,4,1470075.5361428002,2968615.55577348
13,5,2,2,2,11,2178108.77350961,7618018.78189477
12,5,1,0,6,12,1959508.67176586,5616852.40422477
24,2,3,1,4,10,2294285.83739681,2720243.96106799
27,4,1,0,7,12,2035960.57094428,7605134.63056338
26,1,1,2,1,5,1566320.79725345,5691251.40428848
18,2,0,2,6,10,1831843.65742757,5616189.4502895
36,6,1,0,4,11,1993384.2670996997,5565246.33432326
21,0,3,1,3,7,1384256.10708388,5873180.65768748
30,2,0,0,5,7,2040959.73397089,2740701.45066761
35,1,2,0,4,7,1598159.36699209,5232305.39296147
36,5,3,2,3,13,2592515.80408433,9773987.5555985
22,6,3,0,6,15,2973982.71848468,4978537.91420363
25,5,0,0,7,12,2821043.11838911,8343873.37022527
31,3,0,1,5,9,1592627.79174726,6558059.1763120005
20,1,1,2,6,10,1756463.30104053,6864306.63074637
40,1,0,0,2,3,1208448.35311248,4623019.90770975
31,3,3,1,5,12,1600995.13880152,6566920.71404121
40,3,3,0,2,8,1671111.14527094,6806881.58378074
32,0,2,0,1,3,1668526.7746529,2931541.1485309
27,1,2,0,3,6,1735340.14587303,3245974.76871454
37,6,1,2,6,15,1857132.09122358,8344536.93212978
35,4,0,1,1,6,1641535.03560098,5361012.46832515
40,6,2,2,3,13,2561694.90103273,8810387.48068683
16,0,0,1,2,3,1165030.01271353,4875039.45293516
14,1,0,2,3,6,1216457.46898363,7582001.96719183
39,2,3,0,2,7,1582090.41988724,5941328.00978122
11,3,3,1,2,9,1940852.12382865,3567175.08560785
36,2,0,0,3,5,1487041.13854152,4203634.79295655
23,2,0,1,6,9,2065723.97327351,3872719.37418599
15,0,3,0,5,8,1807942.77087719,5792254.84071979
18,5,1,2,4,12,2184338.93130026,7004592.45529564
29,0,1,0,4,5,854710.811790292,5272966.85096193
26,2,2,2,4,10,1547599.34311612,7555798.73560126
13,0,2,0,4,6,1500920.97159686,5767271.192897
29,4,3,2,5,14,2075807.77792588,9507671.37003156
36,6,2,2,7,17,2862458.91620849,8471378.41856802
19,0,1,0,6,7,1749414.62719973,3154902.00731442
17,3,1,2,7,13,2500245.86875737,493853.59643633396
35,3,0,1,7,11,2176806.07108834,9443904.69418113
18,4,0,2,6,12,1749456.9155722999,9424295.02003123
19,2,3,1,6,12,2240902.21240204,8436178.30759737
38,2,0,0,6,8,2130693.37104679,5792940.89340658
29,4,0,2,4,10,2610146.0458732,6605884.48925151
11,1,3,2,7,13,1804628.88307705,8484196.12559241
22,1,1,1,6,9,2097811.71116708,4991026.87357266
35,5,0,2,4,11,1891093.67799073,9189059.68911482
16,2,2,1,1,6,1946503.10347237,2643925.78765214
33,5,2,1,2,10,2048820.15699385,7111536.86979546
40,2,2,2,0,6,1860634.02785159,3047500.28335983
16,0,1,2,4,7,1839684.4939557998,3327464.5629456
38,5,0,1,1,7,1927204.56180723,7590739.26117539
23,3,2,0,6,11,2508632.76296715,6680140.79281137
11,6,0,0,2,8,1723335.06975592,5070925.00055101
11,2,0,2,3,7,1637626.32404708,5942176.5216304
30,4,2,1,1,8,2122082.38598788,3118707.75095561
29,1,1,0,2,4,1088474.15678621,4213410.86808233
33,0,3,0,4,7,1712366.61093767,5688078.42214527
40,0,1,2,6,9,1995027.57694193,8334057.30089836
10,0,1,1,7,9,1880696.52055721,5107461.76336714
23,2,1,2,5,10,2139913.27354509,4569271.84446507
19,5,0,2,6,13,2208638.41918608,7142957.46620968
21,5,0,1,6,12,2182459.19715344,3399217.37741755
21,3,2,2,0,7,1088376.0825576999,5722195.09929286
36,4,1,2,6,13,2494972.18636264,6755911.51274059
25,6,0,0,6,12,2473282.3368582,5532746.94878685
15,4,3,1,2,10,1763043.90618756,2076128.29711088
19,4,1,0,0,5,916323.1600721809,5137752.1356327
20,1,2,2,6,11,2420324.43551607,4770681.21674128
16,6,1,1,6,14,2409594.07346634,5949287.22347132
34,3,1,1,1,6,1827337.67789985,3425805.50360426
20,0,1,1,2,4,1189417.75576576,5671296.76674964
21,4,0,2,0,6,1688972.95068263,5354509.44291066
10,4,3,1,1,9,1999526.2851037,6603130.48623706
25,6,2,1,0,9,1236798.65998764,5714829.19292196
29,1,2,2,4,9,1984837.18215079,2946172.23367972
18,5,3,0,1,9,1501402.26778139,5925773.48051629
13,5,1,2,3,11,1844905.11867603,7815003.80579561
16,6,2,1,3,12,2419972.68925336,5846200.96469224
39,1,3,0,2,6,2100475.16411531,2608666.63147844
17,6,2,1,6,15,2012599.87885246,11165659.8363666
24,0,0,2,5,7,1900808.59116979,6166264.15107751
28,6,1,2,6,15,1895639.055741,7463158.9923806
14,5,3,1,2,11,2069725.55261699,3830143.61666737
13,3,2,0,5,10,2149032.29827287,3780139.07644032
39,1,3,0,6,10,2272259.1492127003,4541572.82721517
34,5,3,2,7,17,1945094.54902729,6063415.77823119
33,0,1,0,5,6,1629273.7531456002,5974019.82951954
31,1,3,1,4,9,2137842.55206406,2867817.40892165
10,4,2,0,1,7,1774795.31786662,4149193.38637044
11,1,2,1,1,5,1385412.79480679,5160354.65753843
25,6,3,1,4,14,2110244.80436841,10482878.943067301
17,1,1,2,7,11,2214888.49030119,5421018.39663278
18,0,0,0,7,7,1392632.28565639,4941782.31187614
39,1,0,0,7,8,1500956.64703169,4087789.55392687
13,1,1,1,6,9,2021035.61044466,5052047.74685356
20,0,0,2,4,6,1601665.28739569,5139563.36606505
35,2,3,1,2,8,1344546.26749843,4203597.93463596
29,5,3,1,6,15,2201709.5756425,9005143.21064494
29,0,2,0,6,8,1423848.30040061,6648107.94015223
32,0,2,0,0,2,1384617.80743438,4494483.89157167
32,5,3,1,4,13,1686415.27175814,6498531.59296861
39,5,1,2,2,10,2708901.61438945,5090039.88478483
34,3,1,0,6,10,2242389.39493531,9107298.11374174
29,3,3,0,7,13,2178614.77561407,6119807.38943441
34,2,1,1,6,10,2113873.85962156,8593503.95421829
26,1,2,0,7,10,1310607.84400488,6490003.84923388
16,6,1,1,0,8,1901388.7189588002,8365554.58954998
35,2,2,0,4,8,1731786.87569762,11859540.5428625
19,6,1,2,6,15,2204598.44688587,8250695.74880331
28,0,3,2,7,12,2460911.9773049997,6612051.80778267
20,2,3,0,0,5,1746590.6985751,4914365.58316666
10,5,2,1,0,8,1947479.06549196,8528569.94983108
29,5,1,2,7,15,2319248.75924089,8335414.53260101
13,3,0,1,2,6,1210919.88787572,3415428.8525841
11,4,2,0,4,10,1735990.75499944,5294213.21336677
12,1,3,1,1,6,1471557.6223218,4615764.66783288
17,2,2,0,6,10,1959962.96239009,4962648.62793316
13,3,0,2,6,11,1656103.79520947,4490294.32969356
21,0,3,2,4,9,2309163.14629793,6889417.35678332
30,5,1,1,0,7,1485284.47396324,4748572.88260976
12,3,1,1,6,11,1819625.58048734,5677515.74670435
39,0,2,1,2,5,1806259.19868657,3078653.44146701
40,2,2,2,5,11,2161011.37871278,4726817.88103141
27,4,0,0,6,10,2520826.00061549,4807220.40754957
37,6,0,1,1,8,1399585.58109491,3353780.55555396
27,2,2,0,6,10,2549196.53846284,6420055.01341745
30,5,2,0,0,7,1729814.80645849,1937698.51888635
37,4,1,0,3,8,2129142.00981772,4057011.74199622
24,1,2,0,7,10,1819388.07468563,8431579.37624042
26,6,0,0,2,8,1438720.25400838,2099058.4769178
20,0,3,1,4,8,2040831.67439472,5495881.42860137
36,2,2,1,2,7,1267274.36467433,3942113.19064623
31,4,1,1,7,13,2152201.93426425,5351868.28487123
32,1,3,1,2,7,1665013.28867953,4984872.14329232
24,2,3,2,2,9,2215912.69610374,7623767.84491325
16,3,1,1,0,5,1578229.71542031,1112560.5751968
33,1,2,1,3,7,1587686.61893836,5998167.49729185
17,1,1,2,4,8,1396734.26857268,6059825.36236991
25,6,1,2,7,16,2234803.30236453,8154458.07281424
10,2,3,0,7,12,2344759.45535527,5716826.4466972
31,0,3,0,4,7,2153300.2037814,4954021.84320485
15,6,0,0,5,11,2172822.58476125,5367267.28853021
32,6,3,2,0,11,2159502.27332098,8469637.36097339
38,3,0,1,3,7,1863354.2190542,5953733.34578137
27,6,2,1,4,13,2454468.67830812,3413152.44560805
13,2,1,1,2,6,1929174.48224051,6253398.89593292
38,2,3,0,2,7,1749039.62028501,5850813.94209338
26,5,0,2,4,11,2240736.08685794,5662238.02472486
28,6,2,1,1,10,1962408.45640847,7318849.75966595
12,1,2,2,4,9,1806363.88848194,9627872.19933585
38,2,0,1,3,6,1809057.14255721,2401450.04146943
13,3,0,1,4,8,2282564.90264014,3671780.58277939
38,2,0,1,6,9,2006408.16086333,2825612.64554116
18,5,2,2,5,14,2318535.22731546,7953656.35536368
35,5,2,1,2,10,1958201.21165256,3579377.81274627
34,4,0,0,1,5,1405754.57845674,7742651.933451201
27,5,2,2,4,13,2284237.82167109,6393191.85681439
25,6,3,1,7,17,3164556.02006408,8295155.8556808
10,3,0,2,0,5,1508124.58771557,5646948.16985031
36,3,1,1,6,11,2091822.7738691003,7950798.28584798
16,1,2,2,4,9,1800920.15078493,5325285.29688045
28,0,2,0,7,9,1931061.20881013,3741283.90640752
16,1,0,1,1,3,870777.3551532229,5102867.35673044
18,0,3,0,1,4,1272462.04788371,2740156.72955801
21,0,0,1,4,5,1818436.89691372,5556721.77756879
18,4,1,0,5,10,2324372.68140912,1519006.04524731
18,6,3,0,7,16,2828686.09643051,10079154.7715252
21,2,2,1,6,11,2523980.06962874,6374279.56165743
14,6,0,2,2,10,2374343.78498644,6301487.24726509
37,5,3,2,2,12,2649531.92357808,8689551.58979918
28,0,1,0,3,4,1205731.75780013,4649704.32566409
39,4,0,1,2,7,1620180.93594938,3491691.68327281
23,5,2,0,2,9,2439141.14149863,5432562.01520164
37,2,0,0,1,3,1196446.79745758,3504341.96688247
32,5,2,2,5,14,2179485.16820939,7652861.11375129
25,4,2,0,2,8,1571322.71573592,5712922.533804
26,1,0,0,0,1,1484027.82399942,4591623.26469922
26,5,1,0,0,6,1831248.60832721,3278258.97269523
15,3,2,1,5,11,2509092.54919839,7816567.43453454
29,4,1,0,5,10,1726420.35478168,6627516.1552573
16,3,1,0,1,5,1532824.21466578,6241510.93876666
19,5,0,2,4,11,2184783.99188743,7277767.65305695
39,4,2,1,2,9,1984914.56857246,7198385.90788122
36,4,1,2,7,14,2966720.67693307,6935243.53708783
39,2,0,0,6,8,1628397.7266272,3150870.35206426
31,3,2,1,2,8,1983581.1525647,9137761.7871744
20,0,2,1,4,7,1414093.66517785,1998996.47453091
35,3,2,1,3,9,1844244.22982076,4913711.61944901
15,4,0,2,3,9,2088650.69278478,7278066.12387844
13,3,2,1,3,9,2757284.2112122,6236361.39071424
36,4,0,1,2,7,1644533.41287662,5833443.16050607
34,4,0,0,0,4,1309781.31294393,4608808.04941407
40,2,1,0,4,7,1527285.84293665,3598359.80082639
14,6,1,2,2,11,2417216.13850357,7611133.066303301
12,6,2,1,1,10,2026532.36014105,5952818.96368622
31,0,3,2,3,8,2331866.83668813,3992976.01252366
13,0,3,2,5,10,2489213.29180368,3937795.77373382
30,1,2,1,4,8,2066541.50947512,5082043.14568221
28,0,3,0,6,9,2152916.03062667,996804.455368888
30,3,3,0,7,13,2618492.76767201,4417016.95562087
32,5,3,2,2,12,2692755.93431596,4154234.41304438
13,6,3,0,5,14,2608767.29404879,9638094.11145816
39,0,3,0,1,4,1396633.02078675,4759387.10532468
29,3,0,2,2,7,1842504.26063543,5890311.50700815
10,5,3,1,7,16,2082200.47244921,7508348.59043956
33,2,3,1,2,8,1899318.49725819,4820001.35417822
16,5,0,1,4,10,1310767.64816527,4901394.84593954
37,1,2,1,7,11,2247314.67784316,6545246.8855678
10,6,1,1,5,13,2608589.69023066,8664722.21607094
36,2,0,1,4,7,1540409.58879905,2113811.48355645
12,6,2,1,5,14,1998609.04703866,7607042.69976325
38,0,3,2,1,6,1806989.17473897,6042846.73489988
17,6,1,0,4,11,2571588.22101711,4969533.88449112
28,2,2,2,3,9,2103275.14701327,5484791.21565204
21,6,1,0,2,9,2010816.51921597,10334601.273646401
40,6,1,1,7,15,2211813.49670306,5805435.85766299
31,0,0,2,7,9,1981890.53969655,3456883.08116843
24,3,0,2,1,6,1583422.44044078,5761634.73526073
15,3,1,2,1,7,1874331.00971288,2979034.37385269
20,4,1,2,7,14,2776096.40494131,7538016.95179466
22,3,3,0,4,10,2387994.94925558,7810347.61687233
14,3,3,2,5,13,2213193.67645553,1956926.02544167
23,6,3,0,6,15,2449429.47518838,9714146.30248093
38,2,2,2,3,9,1861724.9455856003,8783886.58919281
33,5,1,1,2,9,1972544.09048192,5293402.8886054
31,1,3,2,3,9,1608602.66460026,5740162.46195942
29,2,0,2,6,10,2496689.56228603,7244090.25580117
22,3,1,2,5,11,2643668.08953845,7798201.62335169
32,2,3,2,3,10,1488913.24967883,2506880.78222591
31,4,0,2,2,8,2097069.40572984,4754814.00307726
14,2,2,1,5,10,2180100.50204981,5058764.06918334
22,4,3,1,3,11,2165463.64128881,6640467.65048596
38,3,2,0,7,12,1595177.89434151,8700427.19790475
39,1,3,1,7,12,1441152.305084,2669837.95985248
27,4,0,0,7,11,1399472.39801355,5079905.54697562
29,0,0,1,3,4,1272802.45413297,2644577.13469869
14,3,2,1,3,9,1687887.3461787,7632710.41435101
25,4,2,1,0,7,1595177.44515407,3123005.87529737
13,1,0,0,2,3,1463778.09584246,4968346.60553995
34,6,2,0,5,13,2348089.16178632,9257765.251896601
26,1,2,1,6,10,2016227.78145138,5826697.91345167
10,4,2,1,1,8,1526881.72921309,5776592.21348915
38,1,2,1,3,7,2188456.03094338,5213555.47403646
38,4,2,2,2,10,2071050.49554694,8409696.40667429
40,4,0,2,0,6,1661985.25130603,4709252.39076315
30,2,0,0,4,6,1619006.47606413,2562233.19479325
14,1,2,0,1,4,1216074.25914499,2798091.53585434
15,6,1,1,6,14,2909962.02296751,7454026.05648068
29,2,1,1,4,8,2231732.76728719,7484566.13883973
30,5,2,1,5,13,2509989.11606394,4996150.26353063
34,1,0,1,5,7,1495262.84592436,4561202.66289089
31,5,3,0,0,8,2330451.39124661,1339123.36978666
33,0,3,0,1,4,1553862.58558639,4403078.96617807
14,1,0,1,0,2,1265633.41594711,5008166.13370472
34,2,0,2,1,5,1075125.02088418,2889971.9259967003
39,4,1,1,4,10,1913523.48533793,4876864.21368244
34,0,1,0,5,6,2312745.49130559,4924292.73981439
29,4,2,0,5,11,1638965.77847147,6214310.25621423
34,6,0,2,4,12,1915117.49267715,7771067.07045703
35,5,3,2,7,17,3647704.4588815,3176604.94058776
29,5,0,0,1,6,1619879.96295356,3932047.67600407
19,6,0,0,1,7,1439853.7702823998,4334910.6096555
35,4,0,0,6,10,1452949.2920703,8343171.29029264
24,5,0,0,4,9,1156694.4349368,5783016.08542881
13,5,0,0,3,8,1734793.12610692,5291519.70628406
33,5,3,2,2,12,2505193.78343788,7565345.62430039
26,2,0,0,2,4,1671414.10340358,5691986.10618591
38,0,1,0,0,1,1024271.51311313,4298397.99463195
32,0,1,0,4,5,1461076.58036115,3007495.6255233
34,5,3,1,2,11,2535133.48724466,8132098.85783866
36,1,2,1,6,10,2459195.38863163,3538406.33224776
22,4,2,0,0,6,1742257.18834356,3281346.74655186
35,6,2,0,2,10,1757465.41547581,6428952.81828545
37,6,1,1,0,8,961671.7805587441,3473613.68673165
38,3,3,2,4,12,2336635.77969393,9235761.27861098
21,4,0,2,3,9,1728211.13546188,6257211.97590137
35,1,2,2,2,7,1826011.94727028,5323794.607065401
18,3,3,0,7,13,2473474.24801072,8413530.13880632
18,1,1,0,7,9,1625814.92200174,5291118.73776551
37,5,1,1,0,7,1884296.78565838,7334789.50565175
36,0,3,2,7,12,2114842.65962142,7560955.57670433
40,3,0,0,4,7,1589170.09643334,8067302.51774147
39,6,1,1,2,10,2722270.74967824,5521955.73055241
23,3,1,1,6,11,2029651.61492288,6952739.61533009
39,1,1,0,5,7,1835884.67380207,5696475.12968866
32,2,0,2,4,8,1925833.53658971,4498102.1070937
25,4,0,2,2,8,1993292.69595027,4782116.92823505
38,3,0,0,3,6,1687906.89084886,6123656.54304776
24,5,3,0,1,9,2181179.82810204,7458469.89046396
14,3,2,2,6,13,2215450.8975549,10745622.9635319
20,6,2,0,3,11,2458089.99685393,5071535.43341862
15,1,3,0,0,4,1906986.46166554,3695282.73618548
15,5,1,2,5,13,3042827.23064533,7693241.96600809
23,5,0,1,4,10,1856454.15738486,9692944.35705741
36,0,3,2,0,5,1610220.52240144,5630656.11139883
26,6,3,1,5,15,2179608.17261934,8578059.79836705
27,1,0,0,1,2,713782.086302064,4429886.44583915
37,2,1,1,1,5,1393474.41134821,5368225.49451514
27,1,2,2,2,7,1770962.94860274,6399061.95356197
31,5,1,2,7,15,2926005.45103509,7473462.40638878
35,4,1,1,5,11,2442235.36893833,7167476.73591828
14,1,2,2,5,10,1856118.21534121,7824649.02552597
26,2,1,2,6,11,2357132.72006825,7832055.98498554
32,0,0,1,0,1,1126383.02971128,2644501.50730883
11,2,2,1,1,6,1625107.90151794,3772729.99354214
14,4,0,1,1,6,1635737.64341778,2137776.42393454
37,5,2,2,0,9,1907010.77179871,2461236.97547524
22,5,3,0,7,15,2154967.0873129,7446583.33070344
18,5,2,2,3,12,1847566.72686739,6106575.60580505
24,6,2,1,0,9,2024239.97129406,9002873.16187529
27,2,0,1,6,9,1696510.78974064,2651747.113764
11,0,2,0,2,4,1200513.17535789,1766476.34624558
18,1,0,1,2,4,994721.100926925,6522003.21019209
14,3,2,2,5,12,1712604.4155664,6075771.76241121
23,1,1,2,3,7,1923417.97482035,5071916.73500192
19,3,3,0,4,10,2383396.07443425,6887776.71326077
40,4,3,1,7,15,3231716.19048224,6576962.00771938
30,2,3,1,7,13,2291269.76361253,6804650.48609419
14,4,3,0,4,11,1693962.05058856,6895143.19443432
20,3,2,2,3,10,2012281.52337891,6275765.41067792
36,5,0,2,3,10,2439709.41956033,5881293.65542296
32,4,3,2,2,11,1927827.44346839,7331609.00447945
29,3,0,1,6,10,1524481.89645653,4848936.51205514
11,4,3,1,6,14,3211432.33317531,11566899.465389
15,2,0,1,5,8,1944007.43680986,6691681.81093629
27,2,1,0,7,10,1808414.70859414,1621116.78350234
22,4,0,0,4,8,1722161.85464227,5603237.26858228
13,0,0,2,2,4,1345806.66978719,4820102.09206997
13,2,2,1,7,12,2098711.0391549,6293591.761152901
24,6,0,0,3,9,1802282.4573137,6729661.00843008
24,1,1,2,3,7,2068232.65987704,5631392.79096952
33,3,3,1,5,12,2058441.43248997,9292325.63740687
28,1,1,0,4,6,1677647.31132313,4816783.1648905
35,1,3,1,5,10,2194966.45848014,2719167.18375927
12,6,0,1,7,14,2401977.10620632,7884154.37188338
28,1,2,0,6,9,1568250.48005323,5623295.01611178
29,6,0,0,2,8,1833612.74446777,3942610.87310889
23,4,0,1,4,9,1644557.85522338,7848674.577167999
35,4,0,0,0,4,942727.0843661891,5171420.13505113
16,2,3,2,5,12,2717337.54329757,7365459.18682931
33,4,1,2,5,12,2953303.17350308,6992260.8392856
19,2,3,2,1,8,1756136.41153509,1215053.29367467
14,5,0,0,5,10,1628537.39605953,5280764.25580195
40,5,1,2,7,15,2433295.08994233,10305643.602463901
36,0,1,0,6,7,2002808.35753555,4212951.51472424
14,0,3,1,7,11,2466574.90359085,7094977.21797537
37,5,1,0,7,13,2280115.92547997,9617440.89337387
33,0,2,0,4,6,1733864.94952104,4227087.0721123
38,1,1,2,3,7,1526021.85565367,2980847.00132583
22,2,3,1,2,8,1203500.64482249,4929642.71963253
24,5,2,0,5,12,2053464.18396665,7164245.83096664
18,0,3,0,6,9,2006329.3941106002,7482737.30414772
38,4,1,1,6,12,2482169.98829624,8412009.79746588
33,3,2,2,6,13,1647588.96678061,3347276.06705795
14,2,0,2,4,8,1498382.66750731,7001682.02508668
26,3,2,1,1,7,2391890.43743742,6715631.76748276
26,3,1,0,3,7,2078170.60363663,5663902.029516201
27,0,1,1,5,7,1572991.35042422,4093131.0819857004
22,2,1,0,4,7,1575912.28936367,2389070.57401341
19,1,2,0,4,7,1527990.0025314,7336296.28606931
27,0,2,2,5,9,2132286.36628713,5499849.92136319
14,4,2,2,6,14,2659550.56838388,6023728.43849859
17,2,0,2,4,8,2041305.27537924,4563251.87419887
32,5,3,0,6,14,2155163.98212722,8704883.92334065
11,4,3,2,0,9,1927621.72180942,2645296.01948705
31,1,1,1,2,5,1498426.28976157,1822412.59044234
28,3,1,2,5,11,2289887.84830555,6830300.24204714
12,0,2,1,6,9,1583725.37487697,8572195.15515409
38,3,3,2,5,13,3002122.11738003,9426716.71049694
19,6,1,0,1,8,1812607.14306582,4220248.91557568
37,1,2,2,7,12,2644719.34561225,10701285.832333699
40,4,3,2,5,14,1855849.18839394,2989874.27636852
39,5,3,0,2,10,2051221.8242891002,7700372.62830505
32,5,2,0,7,14,2743064.18793736,6171300.02547013
21,1,1,1,6,9,1640707.29089163,8229453.95783461
18,3,0,2,0,5,1712875.96369433,2202974.94131052
21,1,2,1,3,7,1637556.11841584,5037239.32722476
38,6,3,2,3,14,1873920.12539591,5404631.68111083
10,3,3,2,0,8,1791360.46848355,2651769.7042209
13,0,2,1,0,3,983201.8187016171,4757208.95145737
37,0,0,1,6,7,1695580.256402,4060431.85500478
12,0,3,2,3,8,1516758.30033659,4908065.09097264
26,6,3,1,1,11,2450850.7221278,3589935.74866873
10,2,2,0,0,4,1609628.30506818,3895961.62654398
27,5,1,2,4,12,2711102.31394166,6479412.019084901
10,6,2,1,2,11,1784704.5223033,4802320.41965338
23,4,2,2,1,9,2280368.13824916,6334696.89914205
18,4,2,0,4,10,1540032.46121806,6117234.00626139
22,4,1,2,2,9,1556814.97935955,4683912.19911853
19,3,3,2,2,10,1421344.54866317,6596327.20014447
38,1,0,2,0,3,1400926.28927278,5023294.06927812
29,5,0,1,6,12,2345870.77508321,6473343.37679952
39,1,1,0,3,5,1922457.54918968,3911819.11351895
13,2,1,1,4,8,2433917.89767302,4084963.82842614
25,5,3,1,7,16,1970049.68500183,9024859.86518626
29,1,1,1,4,7,1672028.87912308,3840288.97782393
27,2,1,0,1,4,1284484.76704341,4949126.72522525
22,0,0,1,2,3,1761733.07358361,5745858.70223772
17,5,1,2,2,10,2115023.78388588,4470863.47874753
27,3,3,0,6,12,1787883.89182153,7848689.30131152
38,1,2,0,4,7,1669571.42422006,2695015.11537105
32,3,0,1,4,8,2232711.34523135,3298367.1662042006
27,0,0,0,5,5,1544459.61779647,4471487.8998641
15,5,0,2,7,14,2869613.86869605,10417097.433225
29,4,1,2,0,7,1417187.40833152,1812152.59723547
15,0,2,1,3,6,1439763.00415892,3657749.93390141
11,0,3,1,0,4,1615197.13298428,6596400.69586236
18,6,3,1,0,10,2407392.97648914,5596497.6796609005
34,4,1,1,2,8,2234765.79366771,10343614.663162801
21,2,0,0,6,8,2420377.1359372004,3946000.78806782
24,0,2,0,5,7,1756457.63146111,7825613.41768801
40,5,2,0,0,7,1444256.15990345,3785436.2851467994
18,0,2,1,3,6,1558945.66187125,1503555.2872456
24,1,0,2,5,8,1485375.39080931,4706103.74413719
19,2,1,2,2,7,1653584.58133947,8102329.63529307
13,6,0,1,4,11,2361531.72825876,6518392.87161663
17,0,0,0,2,2,1126867.37592326,4232129.18770032
33,1,1,2,6,10,1731027.35244133,6863519.47624612
27,2,3,0,5,10,2008407.65135237,8405469.57258632
18,5,2,2,2,11,2192602.89205163,5789503.53459417
17,4,2,2,2,10,1936062.99229182,5005615.53810553
13,5,2,2,7,16,2514222.13968689,6651679.01598006
13,2,2,2,7,13,2640125.72482475,6206948.15886652
39,4,2,1,0,7,2400088.97877634,3287110.23089059
19,5,2,1,3,11,3159591.25500986,7824042.955599001
20,5,2,2,3,12,1950319.72092968,6055770.91417164
30,4,0,2,7,13,3292628.6640329,7150471.25435684
16,0,2,1,6,9,1743340.61056298,5746587.43357559
22,0,0,1,1,2,1167460.05238699,1378191.27144686
22,2,1,2,1,6,1807469.79526714,4639249.61759452
10,3,2,1,2,8,1574839.57810325,5999776.22177031
35,4,3,2,2,11,1812775.46160762,5375813.06603958
13,2,0,0,3,5,1502132.49030654,4707865.33458436
38,6,0,2,2,10,2016856.68768947,5922865.92193945
21,3,3,1,7,14,2549996.44656824,9806417.25721237
25,4,3,2,2,11,1909827.10832119,6601492.24617821
11,4,1,1,5,11,2279415.95926588,3026399.21738432
14,1,1,0,5,7,1523709.1536283998,3379968.7326355
25,2,3,1,1,7,1400598.77371348,5946627.40538722
22,3,2,2,7,14,2931277.31577936,4376449.90799638
18,5,1,2,0,8,1476737.72646029,5961631.26662151
40,6,1,0,5,12,1842766.45402229,4969652.07048857
16,2,2,0,5,9,2231287.57386207,7526184.67228604
28,6,1,2,6,15,2525138.88670607,4764546.21101804
37,2,2,0,1,5,1386575.74230897,3696228.21691014
11,0,3,2,7,12,2120919.06288785,6999233.53803558
26,1,2,0,1,4,1122455.46363762,4572531.91284986
32,6,1,2,3,12,2397514.42159847,6645777.14527719
37,3,2,1,4,10,2025336.01092781,8292567.46135093
31,2,2,0,6,10,1801744.55187244,5161993.96452685
39,3,2,2,1,8,1761821.58761696,7223639.47449777
24,6,2,0,5,13,2811256.23063387,5126649.97709578
21,3,1,1,3,8,2133973.73476074,5304301.18226111
15,5,1,0,4,10,2100060.84555181,1960237.42547835
18,4,1,0,5,10,1693772.26434969,5076264.840076401
33,3,3,2,7,15,3231298.68342992,6217933.4303263
36,4,0,0,4,8,1988058.66680511,6754317.35658971
26,5,1,2,7,15,2612457.01663799,3726178.83699964
15,0,1,2,1,4,2013834.78295001,3752071.74870545
15,5,0,1,6,12,1904842.18298273,5249790.30904265
20,1,1,1,7,10,1587314.86220536,8286666.23910228
19,6,0,2,0,8,2034504.27582761,4976857.90662226
39,4,2,2,2,10,2118616.78336022,5827919.13421548
28,6,0,1,0,7,1629910.51485688,4752628.75356247
24,2,0,1,5,8,2025945.05492415,1130522.45047279
32,6,3,2,6,17,2834871.77011189,5373827.52774452
39,0,0,2,7,9,1898503.47684678,6829220.22729734
30,3,3,0,4,10,2067510.50217077,5918478.62045292
26,5,1,1,0,7,1601998.26975771,7003667.23414106
10,1,1,2,7,11,2139161.2610925,6375717.50367918
24,5,3,1,4,13,2128618.85220239,6510442.50579427
35,5,2,0,0,7,1627099.87736069,7957830.63552528
23,5,3,0,3,11,2648164.98561658,6185436.27755436
34,3,0,0,4,7,1467385.82618666,8004511.85241438
23,2,0,0,5,7,1591945.09488396,4811303.99015074
40,3,3,1,3,10,2326662.38087697,3439368.2916751998
30,5,2,0,6,13,2384116.17720422,1787418.58494831
13,3,1,0,2,6,1770646.57902938,5726042.32784198
23,6,0,0,2,8,2011046.52776541,8741773.75774633
17,6,1,2,6,15,2379152.91236396,8353260.41197506
18,3,3,1,7,14,2508280.16815106,7767677.21540658
15,2,1,2,0,5,1833543.30404394,4520817.29445262
39,3,0,1,1,5,1667170.82616822,2455480.02073865
26,1,0,0,6,7,1241942.38778504,6425941.32965346
30,5,1,2,3,11,2253941.70906601,6745659.78420812
29,5,0,2,5,12,1748268.13100539,9167643.28586021
28,2,3,0,5,10,1652693.67533821,4444146.77729467
17,0,1,2,2,5,1594907.19669452,3507275.83643704
23,3,3,0,6,12,2195879.19819639,7287321.62612674
20,0,2,1,5,8,1949387.43360895,5306891.72674191
13,2,1,0,7,10,2105935.16141315,5628587.924959299
14,6,0,2,4,12,2207974.98609515,6988475.19000365
36,0,3,0,2,5,1493959.14158793,1247939.37043633
38,0,0,2,3,5,1541267.0792442,4363389.43545294
16,2,3,0,1,6,1332353.92017246,3851966.20752961
18,5,2,2,2,11,1716184.36109761,4363012.13020974
33,5,1,1,5,12,3027890.37200774,10350532.607452301
11,4,1,0,5,10,2159755.56063816,6838037.09977493
15,3,3,2,1,9,1987161.20362271,6533897.09469524
12,3,2,2,3,10,1992450.13266283,6053521.19020039
14,5,0,2,1,8,1532330.89279288,4543050.42846256
38,3,3,0,0,6,1751818.75619219,5201017.13970337
29,5,1,0,1,7,1884289.7466995,6563297.70909929
37,1,3,2,4,10,2066480.86967175,5749520.1694843
17,5,1,1,2,9,2485916.83890272,3843844.13821242
14,6,1,2,4,13,1727061.35383282,8309696.225262201
16,3,2,0,2,7,2557324.81376823,5181961.62255437
12,3,3,2,4,12,1889489.4440243999,4417038.81405417
24,0,3,1,0,4,1209128.03437839,6878778.79895848
19,0,2,1,3,6,2000900.96874338,3972519.94362769
11,3,3,2,3,11,2491779.84658076,7601646.99292219
19,3,3,0,0,6,1712866.8388036,3183242.49066003
21,0,3,2,7,12,2237156.19215706,6102859.82968046
26,2,0,2,2,6,1451325.42216137,2496823.5414314
34,0,0,0,6,6,1045937.86719609,3564693.01211931
29,5,1,2,4,12,1777148.56387476,10824183.49261
35,6,0,1,5,12,2321108.6983292005,4239170.90187401
27,0,2,0,1,3,1301780.08194942,3537047.99251849
35,5,2,2,2,11,2449332.96205908,8864514.73234247
26,1,1,2,4,8,2048358.79377233,5938895.46018819
33,4,2,1,4,11,2224723.58142347,4497445.71000019
18,5,0,1,6,12,1928733.85230708,7981218.73398777
14,1,3,1,1,6,1579034.58757054,4506443.64280372
11,4,2,1,3,10,1844370.73028436,6810995.226606401
34,1,2,1,0,4,1526309.76781022,5256625.01551648
32,1,0,0,2,3,1151361.83054201,2605719.79960049
13,4,2,0,6,12,1757062.14388804,6998301.83172731
13,2,3,2,6,13,2522192.70258685,5472542.50616408
34,4,3,1,0,8,1675052.32243712,6773394.08681382
37,0,3,2,3,8,1815675.53334604,3727593.56788568
35,0,2,0,7,9,2155888.59283222,3498796.55054438
10,0,2,0,3,5,1188487.68236434,3737600.32885173
20,4,3,0,0,7,1848596.48366449,3880125.0523051
32,6,1,0,6,13,2518034.40568884,8552642.11747169
23,3,1,0,7,11,2175841.08397116,9454447.15844652
35,0,3,1,3,7,1770537.12290163,5460169.67561439
23,2,2,2,4,10,2738789.90456771,6513685.54115418
11,1,1,0,7,9,1929576.99890583,7203370.22502817
32,1,1,2,3,7,1658325.24573711,3168438.15592681
18,1,3,1,4,9,1947219.41345542,5861755.97053594
10,5,0,2,2,9,1550428.47358711,6211256.36264811
17,4,3,2,1,10,2089102.08046767,9566920.07202216
13,3,0,0,0,3,1312683.01712376,5000411.00127183
15,6,1,1,7,15,2704754.10574765,8075458.24163543
32,0,0,1,1,2,1473542.48138778,4257551.27210645
29,5,2,0,0,7,1645146.3741415,4411567.69629377
12,0,1,1,1,3,1392331.3745549999,4410292.32754449
10,5,3,1,5,14,2061932.04647745,7083031.7036209
14,3,1,0,3,7,1873564.62412209,3474781.78610826
17,0,0,2,3,5,1546911.38337903,5078768.14040164
38,1,3,2,6,12,2398675.3632243997,6795497.32168808
18,4,0,1,5,10,2385355.47168344,5714308.44148719
13,0,0,0,6,6,1676541.43987161,2749092.93934113
30,4,1,2,0,7,1946835.28250124,4122037.93094523
40,0,2,0,2,4,1541961.53427779,4286699.68232271
35,6,1,1,2,10,1980571.55597751,5949057.269938901
30,0,0,1,4,5,1303833.52029618,3767475.95251311
11,3,1,0,1,5,1183331.05421784,3257764.86732846
22,2,0,2,5,9,1746963.37491591,5662370.05461032
22,4,0,2,5,11,1975672.4682778,5021331.91506067
34,5,1,0,0,6,1524920.70727079,5799961.46116955
15,3,3,1,6,13,2184355.11338243,5792146.76439057
17,1,1,2,4,8,1836280.89566355,4124670.94296823
33,6,2,1,2,11,1855847.4109761002,6923476.00021141
16,1,3,0,2,6,1586425.92107112,4823053.19677524
38,1,3,1,3,8,2216245.43751643,6204594.10058175
29,5,1,0,2,8,1798066.51798991,7276686.56830297
33,0,0,2,2,4,1242504.70888672,7705942.46269552
11,2,2,0,6,10,1345554.39648535,4473977.02448984
35,3,1,0,3,7,1654561.0510988,4051573.34724467
37,4,0,0,2,6,1685751.70004693,6290411.08022834
30,6,0,0,0,6,1152347.3023849,8265682.46125142
36,0,0,2,3,5,1497187.07306025,3950033.70304221
23,3,1,2,0,6,1242551.65691073,6798936.07648379
36,3,0,0,0,3,1453977.24368458,5387148.60370788
24,4,3,0,2,9,2172831.23257892,6087769.14010423
36,4,1,2,5,12,2035677.43410823,7229522.99053412
14,6,2,0,5,13,2462878.81900246,7388354.76673896
23,3,3,2,4,12,2008797.63397223,7235730.82715208
25,3,3,1,6,13,2102894.48539259,7016324.78325308
14,2,0,1,0,3,1418641.10384949,5311874.54650152
35,0,0,0,0,0,1040813.81176999,3218394.67044855
27,1,1,0,4,6,1509537.95309196,4880850.04020315
12,6,3,0,1,10,2174481.07532177,4566720.06134543
25,3,1,2,7,13,2830519.17087429,6567538.71732031
18,5,3,2,6,16,2683109.51662873,3749740.2212139
18,3,3,0,1,7,1557491.92297192,5624309.40313086
40,4,1,1,0,6,1565903.12831734,4731511.35022145
17,1,3,0,5,9,2336765.06644546,8011606.44374663
12,3,1,2,4,10,1786524.13549888,9309690.50741346
27,3,2,2,4,11,2248771.08076307,6756968.39074484
28,5,1,1,7,14,2865095.78681313,2327252.99545604
31,6,3,1,6,16,1930548.33129728,7312117.52380057
29,6,1,1,5,13,2151122.2900906997,5836548.97742023
29,0,3,2,5,10,1369122.30184207,7098813.15596052
38,1,2,2,5,10,1271395.0508129,5494742.07939902
17,4,1,1,0,6,1639822.81792669,4241006.10709635
30,2,0,0,2,4,1091181.46198669,3626702.58374431
18,2,2,0,0,4,1456525.53551253,4195554.73732004
17,0,0,0,0,0,976639.2701057191,2435126.06233997
13,5,1,0,5,11,1945930.20092233,6570618.18729463
31,2,3,1,4,10,2493955.76035635,3800796.48387898
22,4,0,1,3,8,2281564.50268831,5289541.66899397
37,2,2,2,5,11,1667752.87529559,7818070.46112966
26,4,3,0,5,12,2721153.89928779,4832790.78719681
28,4,3,0,0,7,1523681.49349319,3221326.91218898
37,2,3,0,1,6,1453824.99557038,1713009.46400245
26,0,0,1,3,4,1728039.79971587,2973591.05731027
18,2,0,2,7,11,1391159.47933085,7519988.93628939
11,4,2,2,5,13,2200178.91384296,8856349.59128983
40,2,2,1,2,7,2211032.91369804,8047987.707717401
16,2,1,2,5,10,2131495.29736351,7903646.5664432
16,4,0,1,5,10,2315886.04198791,9764102.11608028
21,0,0,0,6,6,1987764.11961753,5581739.188416299
39,4,2,2,5,13,2100491.84244508,7567205.01192988
38,1,0,2,5,8,1990531.37372954,10792996.8458366
11,1,1,0,6,8,2082011.58847846,4433858.85430558
10,2,2,2,7,13,2202288.74803432,6264370.59608048
22,1,0,1,0,2,1064935.39573466,4668918.01881931
25,1,3,1,7,12,1908768.76105406,6870413.09446289
23,1,2,0,0,3,1207446.60626631,4256328.75025053
35,1,1,1,5,8,1172459.13013592,5306744.83280754
21,0,2,0,0,2,1372674.94142321,3918118.63601052
10,5,2,0,1,8,1439712.3389596,6747452.06001594
38,1,0,1,0,2,1242392.57960917,4268194.38298913
17,0,0,0,2,2,995959.423569989,3146571.28870941
26,6,2,2,4,14,2812469.44752755,5213892.19351595
23,0,2,2,4,8,1982332.61076019,4754931.5389583
35,4,2,0,2,8,1278822.02645802,4762643.89589797
26,5,2,2,4,13,1723840.46758121,7021732.65810491
14,1,3,1,5,10,1698696.32617981,742688.039863016
37,2,2,0,3,7,1418700.76342841,3712383.41606003
20,1,2,0,1,4,842342.8988482391,3192015.94886012
19,0,1,1,1,3,784953.346641368,2818924.00120409
13,1,0,2,1,4,1296756.55954261,2652600.31447824
28,6,3,2,4,15,2537138.44066553,9685013.41313056
20,5,3,2,2,12,1923802.7582744998,7189905.697460299
29,3,1,1,7,12,2902941.02864112,2436576.77363517
26,0,3,1,2,6,1154653.97020175,5398696.68328249
28,3,3,0,7,13,2494714.05292903,6385787.22474277
36,2,0,1,0,3,1556297.29486943,5164598.9838597
35,0,0,0,1,1,880248.8879173871,4061492.17884234
26,4,1,0,1,6,1637387.41390812,3375489.75488977
25,4,1,2,7,14,2232858.63944265,10500447.5456696
26,4,3,0,2,9,1758876.38302717,4825776.49356976
12,1,0,2,5,8,1888083.64272449,4152940.97309431
29,6,3,2,1,12,2307296.44302541,5997170.65220894
23,2,3,0,4,9,1548820.83387344,11059441.3683798
32,4,0,0,0,4,1323977.83515963,2644164.42488456
33,3,0,2,2,7,1555510.87864258,7759087.6388422
26,2,1,1,1,5,1709700.79074732,3662964.03671368
36,1,3,1,0,5,1190440.79757998,4353556.52343954
29,3,0,0,3,6,1671302.97648705,6326637.11486305
35,3,3,2,6,14,2818483.22044077,5413771.65387356
30,4,3,1,6,14,2457783.45007578,8193705.25084976
29,1,2,0,1,4,1198977.33530629,3881847.41444931
30,4,0,0,3,7,1750620.35839301,4546205.7105376
36,4,3,1,4,12,2472286.48402934,7636415.65250465
38,6,0,2,0,8,2030351.01526767,6925233.93470352
25,4,3,2,3,12,2020331.97193913,4826235.86293727
23,3,2,1,0,6,1602145.5540314,3914392.60445963
23,3,0,0,0,3,1459361.64709853,3529391.70492221
12,0,0,1,1,2,1196366.60848814,3368544.4782877997
12,0,0,0,6,6,1342279.20967953,4504320.80380357
29,6,0,2,4,12,1485571.7268925,7165753.79866014
20,3,2,0,0,5,1642911.16495085,7521961.70321295
15,4,1,1,2,8,1460147.84439655,2877592.35754668
29,0,2,2,3,7,1524390.13612904,3937577.74010123
13,5,1,0,3,9,1877798.55760281,4639548.05244825
20,5,3,1,7,16,2435089.86349585,7798630.09974873
28,0,2,1,3,6,1592565.52853764,7163141.99737962
32,5,3,0,5,13,2380697.16429287,9233719.54465097
31,6,1,2,0,9,1639699.91971182,5541796.7497845
24,1,2,2,7,12,2159850.13379227,4428931.61916723
39,3,0,0,6,9,1787523.75290854,1523515.46645528
27,3,1,1,0,5,1777112.66946845,6465382.79397525
40,3,0,2,3,8,1928636.70696877,8178569.053061299
32,5,1,2,5,13,2102545.57940777,9457487.33552904
30,6,1,0,4,11,2288347.73511904,6783242.72408264
18,4,3,0,3,10,2030552.87095562,4289086.45243684
13,2,1,1,1,5,1255965.33382744,5037744.68708678
12,4,2,0,1,7,1580707.92969802,4033767.33284704
25,5,0,1,1,7,1722525.06114217,6307079.43024701
31,2,3,2,4,11,2297199.96730416,7063973.92171947
17,5,1,0,3,9,2065122.91722339,7804846.43285178
31,5,0,2,4,11,1630895.59801864,1794235.03026639
22,3,3,0,4,10,2390678.47332652,8351957.82938952
28,5,2,1,4,12,2242848.71306502,3496383.4723886
22,6,2,2,4,14,2041097.05609433,8325580.27033547
28,4,3,2,7,16,2549831.54404465,9900525.82765987
34,4,1,0,2,7,2185259.63538686,4734239.02020688
20,6,2,1,6,15,3388727.78250096,8911239.08130371
19,2,1,0,7,10,2035871.92211689,4771535.54751874
25,0,3,0,5,8,1811505.50209738,1699582.66561946
20,6,0,1,3,10,1861788.89628827,6994979.19586015
40,1,1,0,0,2,1253206.26822886,2818032.4989694
24,0,2,2,0,4,1528279.17865206,6055781.81829598
34,3,2,2,1,8,1395235.41611391,5887550.41390734
36,6,1,0,6,13,2069529.74811975,6131660.41122937
30,6,3,1,4,14,2260445.74392063,5614360.703882701
16,2,2,0,0,4,1508277.84016991,4759901.73216463
25,5,1,1,2,9,2064199.79193572,7222646.91074449
15,0,1,0,7,8,1870727.58985032,6010874.662386099
39,2,0,2,1,5,1601687.02800134,5548426.40225993
36,1,2,1,4,8,2023498.49247019,5112103.5936749
32,6,2,0,6,14,3003322.89240858,9983000.3639887
25,6,0,0,2,8,2225427.07669095,3355755.11104075
21,4,1,1,7,13,2293924.33852666,8998186.22237278
34,5,3,2,0,10,2112127.27299489,7727952.70296472
38,4,2,1,1,8,1952101.29176303,7924437.81985535
18,0,3,0,7,10,2065163.58397129,6497435.26328566
19,0,2,0,2,4,1261998.47942984,4142049.27621939
35,3,2,0,7,12,2193010.89749012,8338669.99221771
11,3,1,2,6,12,1504083.96722196,5179155.70465758
26,3,2,1,4,10,2410794.6641462003,5922671.59095409
12,3,2,2,6,13,2065686.93212713,10449217.9467024
16,6,2,0,6,14,2477038.40300751,7691673.26081722
21,1,0,2,6,9,1498637.13987987,5298489.76813838
21,0,0,2,2,4,1388431.69547453,2965517.02639926
39,6,2,1,5,14,1632816.63971096,6607391.85939715
12,1,2,2,1,6,1714052.16112215,3105621.33133404
37,4,1,1,2,8,2165946.3570804,5961198.69118635
30,4,3,1,5,13,2572798.41479748,8427249.42424608
31,1,0,2,5,8,1421291.07936552,1621514.98983594
16,2,1,2,6,11,2410569.91512078,6925018.326743401
16,4,3,1,2,10,1884237.28387993,7191401.54509305
31,6,2,0,3,11,1963503.62989673,4213149.76786109
19,5,0,0,4,9,1853197.42916943,2909016.03335759
30,1,0,0,2,3,1073501.70672695,4444742.15377344
30,6,1,0,2,9,1798072.62401515,7252613.09099614
20,3,2,2,1,8,2061028.86569267,7065822.89684564
29,1,2,0,2,5,1707539.1879113999,3344957.47333999
36,2,3,1,0,6,1303492.18078273,6286520.87593283
10,5,1,2,2,10,1710524.05040604,3204525.45321491
32,4,3,1,3,11,2126182.45101324,5501369.70648088
36,2,3,2,7,14,2431775.45404456,4381732.73247707
38,0,1,1,0,2,1151162.64027359,4151010.99842404
21,2,0,1,2,5,1793786.98733229,5335217.83225815
30,6,1,1,4,12,1636098.08261472,6423030.3658248
38,0,2,0,1,3,1706858.77171902,3712205.48095286
26,3,0,0,4,7,1857392.34600841,4601748.35521362
12,0,3,2,0,5,1383288.56355423,4311892.33890596
21,5,0,0,5,10,2078704.95470957,6061517.29978569
15,4,0,0,3,7,1726976.38143249,5592683.2236356
23,0,3,0,2,5,1397202.05262855,4226534.17611355
33,0,1,1,5,7,1207788.48844805,6212923.80381888
17,4,3,1,3,11,2302545.9248245,8771656.86755548
18,5,3,2,6,16,2931708.02365831,5151951.2384007005
34,3,0,2,6,11,2021258.29121523,3483903.19879024
29,3,0,1,5,9,2150908.29211117,6720405.68107533
11,1,0,1,0,2,1105163.95223243,3553204.1582612
34,2,2,1,3,8,1594648.30283988,5259775.10168746
31,3,2,0,5,10,1913022.16159417,8285784.68993822
18,3,1,0,7,11,1804378.11510138,3370674.18186695
13,4,2,0,3,9,1454108.38777676,5109858.58394881
35,3,1,1,0,5,1353028.10207677,4512016.38497439
16,5,3,2,1,11,2025672.51594474,6133332.39744896
30,6,0,0,2,8,1678552.06373333,7206934.11740199
35,2,0,0,2,4,1270900.85527548,6511817.79807522
38,2,2,1,6,11,1675935.84801474,1659695.38854066
27,3,2,2,5,12,2132960.53316173,5609937.43302201
39,2,0,0,2,4,1379535.84786716,2194275.86879249
28,5,2,1,3,11,2384177.95590452,3316142.53445565
26,4,3,1,7,15,2716783.00771354,6086495.25110219
40,6,0,0,6,12,2405568.68503837,4368845.3801132
31,3,3,1,7,14,1805629.34604244,8795912.16198615
17,2,0,0,0,2,1269244.49377644,2281118.77382056
38,5,3,1,3,12,1797780.50053877,6552879.78213192
36,1,0,1,7,9,1863536.55852508,4709794.80156805
23,1,3,1,0,5,1649716.64805965,5335996.16089884
13,4,2,2,5,13,2524225.31555994,5325561.85042575
20,6,2,0,0,8,1948819.32643392,8075668.97596164
22,0,2,0,6,8,2095726.88628904,5642470.98330975
24,3,0,0,5,8,1870309.76169407,5269680.59924263
12,0,0,0,6,6,1401743.2518334999,7072096.60654534
13,4,2,1,7,14,2316238.85288105,3925997.83644806
18,0,3,2,1,6,1426799.84811605,1549854.28987162
27,1,1,0,0,2,1224604.16182616,919003.6608815241
12,1,2,0,0,3,1548984.46670911,6421110.69232232
26,1,2,2,1,6,1425811.99290226,4156370.8395642997
38,5,3,2,5,15,1763166.28680123,5114781.91643443
11,3,2,1,4,10,2345859.05075084,2385956.77186542
25,2,1,0,3,6,1750380.12400587,6645202.59709513
33,5,0,0,2,7,1152962.40612052,5266032.71227401
13,4,3,2,2,11,1958285.01851441,2792955.12632322
36,1,1,2,6,10,1695040.32353821,9347942.83275345
24,6,3,2,4,15,1966014.66328096,6115142.75839517
28,6,0,1,3,10,1908489.45182433,7977634.92777517
30,6,1,2,6,15,2564570.3773822,6487241.45241967
13,2,2,1,3,8,2084852.02425939,6228599.61011106
35,4,0,2,3,9,1806869.35958704,4843432.93139493
18,2,0,1,1,4,1553347.84618255,4350350.64616416
24,3,1,1,5,10,2591100.52807217,2982182.23113056
16,4,1,0,6,11,1910043.35193278,6409527.37649364
26,4,3,0,6,13,2551014.44067977,4337844.69183327
30,5,1,1,0,7,1344233.55624403,5365141.69503916
14,1,3,1,0,5,1272003.08832099,3851039.97909447
18,0,1,1,7,9,2083430.47904584,3399746.20685717
10,3,0,1,7,11,1598111.42801792,7562684.20739327
34,3,2,0,1,6,1519309.40695618,3590141.44461959
33,3,0,1,7,11,2644680.87933225,9285081.53811057
26,4,0,0,6,10,2383400.24095402,3977383.12600952
13,5,0,2,2,9,1766103.01767678,8631879.02949192
19,3,2,1,5,11,2303992.95576503,8166789.58846564
12,6,1,2,7,16,2993792.62728209,10479757.362592401
21,5,2,0,4,11,2281233.59271234,5870867.15993159
34,1,3,0,0,4,1512830.91528294,4044783.9560434
12,6,1,0,2,9,1552695.3862658998,5977147.93359778
13,4,0,0,4,8,1418283.5614552,5162937.41375636
27,2,3,2,6,13,2334428.89665073,5549123.55554566
15,2,1,0,7,10,2299822.29466253,6870537.99095136
38,5,0,2,1,8,1529772.69141641,3673229.44393731
40,2,0,2,5,9,1719338.58996511,3763433.10143635
36,3,1,2,3,9,1696695.42069179,4992289.90112784
29,3,1,0,0,4,1246758.65018896,5188252.31895412
10,5,3,1,7,16,2538171.03709442,5869838.21459462
35,0,3,1,7,11,2505871.20148775,4423643.66211394
27,1,1,1,1,4,1176104.9395458,5446952.62119376
29,4,2,2,0,8,2170950.79366382,3458436.88353904
38,6,2,0,3,11,2288847.36581735,10496794.6388425
29,0,3,2,2,7,1268993.39676027,5371378.29938163
10,5,2,1,6,14,2173787.5885326997,10222533.568139
29,0,3,1,2,6,1405994.52523113,4956905.20003568
19,6,1,2,1,10,2218555.18444421,8013443.55045548
25,5,3,1,4,13,2495545.3115903,9585110.40459619
35,1,1,2,3,7,1657670.54267877,6443692.73276976
36,3,3,0,0,6,2001547.50765064,2815586.60524763
39,0,3,1,0,4,1422643.26724135,4515432.84972023
12,2,3,0,4,9,1349204.46018111,6845844.28600747
30,1,2,0,1,4,1194105.75064324,4495456.37924118
32,3,1,2,1,7,1796217.71748432,5768628.33641204
17,2,0,2,6,10,1956264.08455049,6861885.94950831
23,3,2,0,6,11,2278315.44372081,3931166.6048188997
31,6,0,0,5,11,2601210.48094694,9163119.87870515
13,4,0,2,5,11,1627640.61703762,7366920.6919198
38,3,0,1,0,4,1745862.11769506,5584234.67572145
12,5,1,2,1,9,1655410.14803284,5905114.73525322
16,5,2,2,6,15,2371886.91772982,7661801.35598627
10,5,2,2,2,11,2381120.22102499,7044012.12829372
37,2,1,2,4,9,2382693.15305154,5191673.70157077
20,3,3,0,6,12,1855333.97477908,9381867.71998364
37,4,2,0,1,7,1845894.77765227,4205882.55894145
24,1,1,0,1,3,1389256.04633991,3510021.38663646
27,2,3,2,7,14,2832274.9313932005,5960514.46617625
36,4,3,2,2,11,1709775.84615251,5190031.02921177
27,5,2,1,6,14,2349039.04479405,4289285.61222747
18,6,2,0,6,14,2851832.17392174,7319949.52888999
17,2,1,2,1,6,1548779.64958698,2921273.82540498
36,4,2,2,2,10,2247872.66748308,7983225.61378166
11,5,1,1,6,13,2095260.55367474,8263263.69529622
16,3,3,1,5,12,1917855.11847234,6876609.06240284
10,4,3,0,7,14,2357186.37145971,8100886.76565142
35,0,1,1,4,6,1384843.32873248,3861285.46584574
36,2,0,1,4,7,1942979.81916068,6801753.984136099
36,4,3,2,1,10,1515496.40101217,6723353.004981
34,1,3,1,1,6,1808712.14569083,4346977.64357597
10,3,0,0,6,9,2037779.34034179,7176702.52624812
12,3,3,2,5,13,2185513.67024585,9844544.76223015
15,0,0,0,1,1,1205677.94954227,1205677.94954227
13,1,2,2,0,5,1404126.74088815,4892288.26669429
17,2,1,2,1,6,1584966.50336237,7352592.83348549
15,4,0,1,2,7,1789511.84102173,7770874.59395028
17,1,1,0,6,8,1423267.3926487,5534020.05261692
23,5,3,1,1,10,2013984.2849807998,5600615.43492714
25,5,1,1,4,11,1638054.11307236,5975623.39239736
40,6,3,1,0,10,2083742.03614568,10466527.6472467
35,5,2,0,3,10,2186638.17992547,6206967.76765089
21,2,3,0,1,6,1970700.64185338,3405899.14694679
13,6,1,2,3,12,2278647.79871885,4589577.51620743
17,0,0,0,3,3,1190007.67614591,3101500.17169359
32,1,3,0,2,6,1608723.17158516,6204312.61745709
30,1,0,0,3,4,1808736.22516592,3699511.08025099
20,2,0,2,6,10,2744458.57738197,5333551.18499221
14,1,2,1,5,9,2003576.62298736,2825005.03696984
37,3,1,2,6,12,2240289.79745323,6705032.4218354
35,1,0,1,6,8,1910368.61710152,6969742.03443861
35,4,3,0,5,12,2536622.89045545,4585124.97741051
28,1,0,0,2,3,1237392.24711186,2324956.61831735
10,1,1,1,1,4,1523844.59858006,5132608.88454973
26,3,3,1,6,13,2368313.01123232,5541375.90437899
39,1,1,1,2,5,1832820.51267902,6143029.44743381
31,1,2,0,3,6,1577828.96280839,5093754.43983516
31,6,1,0,6,13,2836022.63076378,6540064.87034083
39,3,3,1,4,11,2444181.75446296,7859060.85166895
28,0,3,0,3,6,1761622.18084483,4642532.20852245
24,4,3,1,3,11,2531190.14135372,7121803.65697083
33,2,0,2,6,10,1859630.64692364,8154965.22546217
36,4,2,2,3,11,2038592.42656444,4844203.77542862
10,2,1,2,6,11,2473646.94910629,1153503.69855801
15,2,0,1,6,9,1988440.60320215,5244862.47352659
38,5,2,1,3,11,2580966.15541398,3189441.2113220003
29,0,1,2,5,8,1080050.30714575,6329693.74769731
36,2,3,2,6,13,1954555.67951338,8007100.1078679
25,6,3,2,7,18,2193402.82940527,7511803.88685562
26,2,0,0,1,3,976970.9970282529,2501452.25549602
27,3,0,2,4,9,1479298.74287747,2332681.77410987
38,6,1,1,3,11,2160503.99141889,3589043.76938274
11,1,3,0,6,10,2276967.20309567,9356424.03747365
11,5,0,1,2,8,1214901.63716413,7126644.35807227
26,1,1,0,5,7,1642719.08391013,5604777.04977296
13,3,1,1,0,5,1510565.42342936,4080864.8934150003
19,0,0,0,3,3,1616358.88771961,4441081.35049422
26,6,0,0,7,13,2443765.61394684,5970265.25913608
11,6,3,0,0,9,1559346.92539892,5011277.09521376
40,6,1,2,1,10,2355432.65795937,3124663.93774945
21,2,0,0,2,4,1210133.62532137,2556690.2586988998
31,1,3,0,5,9,1778518.71718109,3958082.07286777
12,2,1,2,7,12,1959728.36302498,4498068.60055171
29,3,0,2,2,7,1830035.40747384,4969720.45014867
30,5,0,2,1,8,2219670.15133611,5799944.88524698
37,4,2,2,1,9,1854518.89258802,7099961.95908784
36,0,2,1,1,4,1049587.83955711,4358332.9442028
20,3,2,1,2,8,1300811.61693888,4344520.3016241
21,4,0,2,2,8,2070695.47473909,5193424.66098442
21,3,2,2,2,9,1724927.3697637,8453925.82865259
21,3,0,1,0,4,1427704.7102437,4195188.82747251
13,4,3,1,4,12,2295125.3935904996,4446486.54257335
17,2,3,2,7,14,2453536.76427414,7245204.57738861
30,6,0,0,0,6,1142762.65476347,5417308.07280767
27,1,1,2,6,10,2399271.27370457,5974446.28239643
29,1,1,0,4,6,1436089.24791648,5812245.13586755
34,2,1,1,1,5,1417726.17056462,5394408.67310843
21,0,1,1,6,8,2374892.26631048,7314408.01506818
21,5,2,1,4,12,1860853.1989348,4893541.51298226
26,3,1,2,4,10,2378693.5268645003,8260069.02775395
30,3,0,1,1,5,1428517.56105636,7174381.17811234
15,1,1,2,4,8,2003595.81328092,8083965.33311091
24,0,1,2,2,5,1484508.85182872,2628922.53241446
29,3,1,0,3,7,1695864.25092386,4071282.9065013
19,2,1,0,2,5,1452753.10211447,5109635.11327455
37,6,2,1,4,13,1977881.82729205,8811724.25606766
35,0,3,0,3,6,803736.2837859909,5869725.7958698
32,0,1,2,7,10,2300294.20307482,3929464.66142485
30,5,1,2,2,10,1775274.6857978,6657929.48885337
12,5,1,2,7,15,3082875.29573055,8196268.43088388
21,1,2,0,2,5,1116177.84778844,364460.549330667
23,1,3,1,3,8,1657863.75207331,4993362.65191028
27,0,2,0,5,7,1686973.83600695,5955015.27462313
22,3,0,0,7,10,2153415.51667535,8867497.75986319
38,3,3,1,1,8,1139250.1127028,8586961.55290264
25,4,2,1,7,14,2467130.07951438,4325380.83043664
24,2,0,0,7,9,1834121.61803299,8219971.72985026
10,4,2,1,4,11,2225056.02018159,8039169.44206092
29,6,3,2,1,12,1637033.44877569,3656866.13159425
23,1,3,2,1,7,1828462.39221689,5821872.66268307
10,6,3,2,2,13,1371779.77348511,6014332.40776739
20,4,3,1,6,14,2102825.55939607,7855162.08073911
33,1,1,2,2,6,1698977.90272202,3610669.58067361
31,5,2,1,7,15,2750783.25016941,10336097.826668
40,5,1,0,4,10,1684299.6469238999,4842352.13165298
26,4,3,1,4,12,2563611.14624314,6886617.35538327
40,1,1,1,1,4,1646189.46074922,3191897.93096464
13,6,1,1,4,12,1647214.71250249,6609098.54761062
34,0,1,2,3,6,1612125.36388722,7349643.21945906
11,6,0,0,3,9,2088605.59378888,6959961.20402782
35,4,0,1,0,5,1729376.03103745,3750557.84887245
38,5,0,0,0,5,1502832.39639086,4886418.66016306
35,4,3,1,3,11,1761233.14692009,7538861.36310287
11,0,2,1,0,3,1192307.27408078,2801601.68952305
25,1,1,1,5,8,1794356.15181505,2853273.46763327
31,1,2,2,1,6,2100441.51274524,4800001.00962027
28,0,0,2,2,4,1545302.52398856,4585816.32260362
22,1,2,1,3,7,1959864.4927365002,5231427.81935985
11,1,2,2,3,8,1985867.07880493,4043401.70551862
10,0,3,1,0,4,1514076.58843493,1836128.80722035
11,5,3,0,7,15,2074948.85451355,9025718.70580544
36,0,3,0,6,9,1690463.36914683,6657873.65863607
23,2,3,1,5,11,2133818.6908163996,3024401.40611439
18,3,3,1,2,9,2309202.07894798,5307622.22848342
11,4,2,1,1,8,1504853.15128876,7260879.16093835
31,6,3,1,6,16,2776743.97230064,7022676.59577383
29,6,2,0,6,14,2347036.87265036,6834644.62279358
30,1,0,1,0,2,1267694.37345952,5550253.51556944
22,5,2,1,7,15,1475781.5170526002,9865028.16595009
36,6,2,1,5,14,2568775.17379539,5663157.980042201
19,1,0,0,7,8,2060578.36361936,4993258.4060135
14,6,1,0,2,9,1737785.89866178,6013769.21541142
34,1,2,2,3,8,1834997.02061267,3831837.79949126
39,5,0,0,1,6,1840837.58421117,6933792.98722232
31,5,1,2,5,13,2055487.19963277,6726339.94208094
12,2,1,2,3,8,2004248.31419443,6161562.69909916
19,6,2,2,6,16,2908405.34777003,6579173.78968942
33,6,3,2,7,18,2014498.87530511,6499147.50691951
22,6,1,0,2,9,1857791.00210215,4382201.92211592
19,5,3,1,0,9,1642942.82541353,2948252.55013393
32,5,3,1,2,11,1924940.10954036,5570825.2360125
17,3,0,1,0,4,1330433.93514226,3075687.53084876
36,4,0,1,6,11,2348906.34919751,6801725.83255848
13,3,1,2,1,7,1493341.3498905,6021567.17996302
34,1,3,1,0,5,1470949.08018867,6254969.99850457
18,3,1,2,6,12,2067230.19317547,4062823.1953457003
27,4,1,2,0,7,1712961.88561723,3239289.27841769
14,4,1,0,2,7,1615240.0738721,4823088.49567327
37,3,1,1,0,5,1481435.11777484,3242754.67556401
17,3,0,2,6,11,2074011.55499876,5298867.7073975
12,4,3,0,3,10,2227610.20827483,8221672.87448244
36,4,1,1,4,10,1876708.73821186,3297541.56060685
29,3,1,0,2,6,1371367.23950584,4171178.64711661
27,0,1,2,0,3,1230983.21414864,3487377.63376197
39,4,3,0,4,11,2082807.55338277,5279669.42436258
39,0,2,2,5,9,1639626.03226983,5238224.63652394
26,6,3,1,6,16,2641670.41995182,4169785.35146242
22,0,3,1,3,7,1374730.91899965,6043519.14980266
14,3,1,2,4,10,1613185.27223526,4576167.46588935
16,0,3,1,7,11,1800732.27193331,5624655.3568933
17,2,2,0,5,9,1909917.64682701,3808214.9920798996
15,2,3,0,1,6,1667902.83334699,4358586.54185897
28,3,1,0,4,8,1872307.16125838,2053681.89963956
13,0,2,2,6,10,2492360.14518674,4482491.57839132
29,6,1,2,6,15,1920987.12055838,5667448.54413425
29,2,2,2,1,7,1513539.52376485,5296096.87821273
34,4,1,2,2,9,1512158.75648938,4379207.22231201
24,3,0,1,6,10,1595649.72181807,7367948.36670039
20,0,0,0,6,6,1780770.58845891,6996821.099132201
38,3,1,0,5,9,2054881.44429373,6252959.25920554
30,0,2,1,0,3,961965.020924905,5666286.57713595
10,5,3,0,7,15,2468325.72741599,7101960.18182133
17,4,3,2,6,15,3023712.93416379,8247588.152121901
22,4,3,2,4,13,2328127.94285848,9796493.87127585
40,0,3,2,6,11,2047543.05502045,6914789.06053903
15,6,2,1,4,13,2800455.87300962,5752826.16669344
33,4,2,2,4,12,2279855.50969197,3632558.73238155
31,0,0,1,3,4,1241806.2744602,5426827.45667062
19,0,1,2,4,7,1965680.04061592,7190070.22596881
26,5,1,1,2,9,1791447.72761724,6205853.95027824
13,0,1,1,3,5,985877.357088422,5169211.88521818
35,6,2,2,5,15,2406672.80095269,9512799.35822592
18,1,0,1,4,6,2083387.05059805,5299493.33354501
32,2,1,2,6,11,1623418.25462763,5413805.69758984
40,2,2,1,1,6,2168424.36955569,1420982.99168641
25,5,2,2,0,9,1504908.78090708,2984510.63897004
26,2,3,0,4,9,1935048.0761807,7282184.84292873
23,2,1,0,2,5,1695610.08176858,5015132.19417884
12,2,0,2,1,5,1584338.03860348,3639004.01570136
18,2,2,1,2,7,1237469.84746253,8636003.82203365
38,6,1,0,2,9,1359592.1342693001,5324666.33833245
21,4,3,0,3,10,1985688.88036791,7752442.90601502
19,0,2,1,3,6,1261842.14264709,2105781.25929695
26,5,3,0,2,10,1943421.07538039,1957717.86612154
30,6,0,0,1,7,1543526.04461679,4154773.8581772996
33,3,3,1,0,7,1396659.17647975,5980384.18640963
38,2,2,2,5,11,2748711.73255301,8307899.38293071
25,0,3,1,6,10,2228504.18188158,4697487.24691623
21,6,0,0,4,10,2977228.81397145,6554727.05523633
30,5,1,1,1,8,2106807.88384645,5569568.21622477
14,3,0,2,4,9,1871623.64542532,4916279.87938021
22,1,3,2,0,6,1639293.0264876,2152234.81600958
34,6,0,1,3,10,2101587.07725432,6525492.49353042
39,1,1,1,2,5,1579334.16991351,6537830.1715098
11,6,0,0,1,7,1464911.69228324,5169764.06815547
27,1,0,1,5,7,1771435.05694995,3396884.89179073
28,4,3,0,7,14,1545962.19162698,6600294.52245063
15,5,1,1,0,7,1835457.51310934,5613851.11861927
22,6,3,2,4,15,1517131.44140958,5575585.12844852
24,1,3,0,4,8,2266766.9619448995,9279595.96520399
21,4,0,1,0,5,1650449.04734751,4616631.12990463
24,4,2,0,3,9,1375006.2465306001,6165253.957394999
14,5,3,0,1,9,1993143.23120423,7790405.36938139
17,6,2,0,4,12,1450752.10644732,9035295.46176978
12,3,0,2,6,11,1312496.8421965,6002615.20419158
29,4,0,0,1,5,1628968.80986642,2723102.62139888
26,5,2,1,7,15,3291923.12504565,13846753.4454746
21,6,0,2,3,11,2541843.65134174,4690783.03850541
29,5,3,0,1,9,2254114.94864257,7220480.41919439
39,3,0,1,3,7,1601370.45494919,5960898.47293312
36,1,1,0,5,7,1445663.57930069,5060800.85938972
13,1,0,0,7,8,1659944.26620535,2418415.69057568
12,6,0,2,7,15,3212066.58319346,9199907.90218018
21,6,2,0,1,9,1647604.61910441,5097805.95909
12,4,3,0,6,13,2770036.43270143,8899495.76291781
39,4,3,0,1,8,1383024.86529793,5501333.41006786
27,6,3,2,4,15,2708369.16568097,9648723.9738159
13,2,1,0,5,8,1596590.68378631,4767373.68736682
37,4,0,0,6,10,2242218.79977291,3700940.07198056
23,0,2,1,4,7,1910672.01626817,1854499.38915892
35,4,0,0,2,6,1965824.43698387,1453942.44988184
16,3,2,1,0,6,1241991.02551915,1298919.7114526
18,1,1,2,2,6,1452460.79161644,4241395.60853484
23,0,0,2,2,4,1475885.10173472,5260871.03267579
32,6,2,0,3,11,2491317.19045099,5826155.48528186
21,1,3,1,0,5,1329359.91123386,4376683.78174898
10,2,0,0,6,8,2017858.01248139,6008910.61353473
19,3,1,0,2,6,1455718.16559573,5689800.53611941
16,4,3,1,1,9,2074821.59332526,2082558.14276645
29,5,2,1,4,12,2120188.43125195,8375811.05022621
40,3,1,1,0,5,1607231.84947112,2594866.95658161
40,5,2,0,3,10,1711877.13395655,5612225.01763665
17,0,2,0,0,2,1007038.06324556,3335642.28550119
31,4,2,0,0,6,1610596.58370321,3184337.59886979
21,5,0,0,0,5,1259347.87746022,7225998.30717512
33,6,0,0,5,11,1834368.08299371,5518973.14227437
14,2,1,0,7,10,2293382.62899517,7334154.04842579
14,3,0,2,2,7,1458737.11971189,2971042.97787544
32,0,2,2,1,5,1648103.4265577,3003515.20517847
19,6,2,2,7,17,3226345.30299724,5829301.66868612
40,5,1,0,3,9,1870713.52091808,7612017.60745534
22,6,3,0,6,15,1783309.56411229,2056040.73881786
33,4,1,2,3,10,2202464.91482909,7076133.61970341
31,6,3,2,1,12,2471149.3690046,7826568.96582913
27,1,1,0,7,9,1496826.35263159,5101020.930236401
25,5,0,2,7,14,2307051.12421553,4782754.83749752
11,1,0,0,6,7,2139822.78671174,7825989.313035001
19,4,3,2,6,15,3084614.26416985,6018690.91921531
17,3,3,1,3,10,1856001.9214954,6665262.90734681
11,6,2,1,6,15,2582350.82761994,8662246.23061248
10,1,1,1,7,10,2094019.31653515,5793841.11172001
39,2,1,2,3,8,1433169.01956727,4649454.91520805
26,1,2,2,6,11,1890044.93491429,8058561.95079731
40,3,2,1,6,12,1917203.63198033,3059316.50342006
20,5,0,1,1,7,1685916.9193387,3706657.78652335
26,5,3,0,6,14,2796093.58938911,8885402.48494393
20,1,2,0,0,3,1747063.94395345,7372670.27243272
24,3,2,2,1,8,1298174.48492664,4855884.18091736
27,2,3,1,0,6,1705521.75459951,2673539.67159006
24,3,2,1,3,9,1333207.07490196,6804042.00570546
14,6,0,0,5,11,1968449.4585662,9386095.39072354
30,1,2,2,2,7,2070886.81137546,5874868.24744924
22,3,2,0,2,7,1935079.68684965,4026959.90372831
21,1,2,2,6,11,1613770.23429913,4990058.47523913
26,3,3,1,1,8,1724828.8096522999,3343606.64300145
23,3,1,2,7,13,1881700.45664749,4784731.80824167
39,4,1,1,6,12,2936891.52798458,4277374.40656059
17,6,0,2,1,9,2040593.08138582,6743955.99817586
14,4,3,2,2,11,2753992.08819208,5541965.38436052
35,6,2,2,2,12,2099455.14722149,7474518.14743359
36,5,2,2,1,10,2112204.76755059,1703756.49970164
27,6,1,1,1,9,1453573.83493605,5623977.37495528
28,0,0,2,6,8,1605369.91281661,5160755.78444587
39,6,2,1,2,11,1932884.46662642,6828326.51119222
25,2,2,2,1,7,1955445.50679351,2278623.78536578
13,2,3,2,7,14,1828912.33483452,4090274.42650163
19,2,3,0,1,6,1405681.07585984,2229506.03322597
29,6,3,0,5,14,2224563.99513753,8051934.72459845
37,1,2,2,3,8,1837999.77629132,6629705.43326106
31,6,0,2,4,12,2225254.48738864,4314177.369786
26,0,2,2,6,10,1883557.21273343,3996133.40305814
30,2,1,1,7,11,1695409.04568509,5129305.77012333
36,1,2,2,0,5,1696291.63079949,6116298.50527436
36,0,2,0,0,2,987675.187724788,5374230.63307153
26,4,0,0,7,11,1848986.30041299,6066733.05262922
24,1,1,1,2,5,1501878.67616173,3997956.42400309
40,4,3,0,2,9,1773643.57479599,4611725.73997126
19,2,2,0,2,6,1390395.46781631,3620757.88615069
18,3,3,1,6,13,1681659.37377876,9552001.3539358
16,4,3,2,5,14,3085736.52816334,8883275.49778417
26,1,1,1,5,8,1703905.64972856,6061321.14827981
35,6,0,1,0,7,1918063.51979738,5592710.3886105
35,5,2,1,5,13,1584937.57256116,4223718.60266171
32,4,1,0,1,6,1607395.65119171,5541389.31901034
22,4,3,2,4,13,1761820.52545197,5778358.27857022
34,5,0,1,7,13,2592738.83344727,8163097.49290161
29,1,3,0,6,10,1724418.81007809,2823248.24358566
16,4,0,0,4,8,1806195.98939583,4465052.59650572
17,3,2,1,0,6,1215680.79520543,3126625.8933976004
19,4,1,2,0,7,1454425.95109231,5808394.67693588
28,1,2,1,1,5,1638265.82934184,6725716.40011639
19,2,0,2,2,6,1377263.73211672,6344262.56038102
19,1,0,0,4,5,1885907.43937912,6707065.74374222
31,3,2,2,6,13,1890143.82764215,6982716.58536519
10,1,2,1,0,4,1302032.99686658,5007097.19348097
26,2,0,0,1,3,1297870.73108495,5162043.19342132
23,0,1,1,7,9,1642251.08872293,4395429.93785041
36,4,1,0,5,10,1795150.91819782,7170596.71379004
34,0,1,1,6,8,1827195.32095502,7462128.95154148
35,4,2,0,6,12,2798065.4731386,6228653.17362265
26,4,3,0,1,8,2226863.60974529,4485912.59722581
13,2,0,2,6,10,2239370.53988219,6071533.87644025
16,0,3,2,6,11,1168120.68725819,6611034.95324199
22,6,0,1,1,8,2355812.46967647,6768556.29003343
17,4,2,0,4,10,2264838.62035232,6611165.00023198
18,4,0,0,5,9,2484591.5774595,6508376.26003268
29,1,0,2,1,4,1296472.20954543,5571589.73402039
31,6,2,1,6,15,2530538.51361986,5526161.35666539
24,5,0,0,6,11,1972627.44758968,6719726.3348232005
27,0,0,0,2,2,1504003.49536136,3773694.18906329
18,6,2,1,4,13,2742468.96455246,3762249.1306462004
17,3,3,0,0,6,1909076.22174049,2815477.23136343
20,1,0,2,2,5,1505356.53028479,2561651.88004165
22,6,0,0,1,7,1651147.78092026,7859306.62823082
21,3,0,2,5,10,1811834.86522006,6832253.47634898
12,6,0,2,3,11,2539715.95435848,4846354.01774167
21,1,3,2,7,13,2818044.23126369,2853909.49531521
19,0,3,1,7,11,2392401.90530073,4463095.63228629
22,4,3,1,2,10,2276917.30160222,9199906.615384402
36,4,0,0,7,11,2340450.03283736,1542187.07949624
24,0,0,2,7,9,2145030.25991497,7162456.97105988
30,3,0,2,4,9,2055821.94825724,9650924.17866195
39,4,1,1,5,11,2162753.87127278,9503803.19371283
28,1,2,1,2,6,1574523.26965673,2276674.50862916
25,3,1,2,6,12,2301032.52402972,6822031.81130699
39,6,0,0,2,8,1794896.32929643,7979096.91487348
19,0,0,2,0,2,1233476.57407193,4844456.86585368
11,5,1,2,4,12,2571249.22358621,5710480.17124545
21,0,1,0,0,1,1353978.91270001,2707450.42045687
39,1,1,0,1,3,792108.36746525,3934682.72123016
19,1,3,0,7,11,1423917.82945828,5969500.74118888
14,1,1,2,0,4,1828951.60092463,2949778.6581817996
33,0,2,1,1,4,1781644.75810082,1413445.98218917
37,2,0,2,3,7,1841445.46267693,1783220.08773629
22,5,1,2,5,13,1903837.32313764,6798944.45741798
40,0,1,2,7,10,1935998.16326271,4543758.9229293
33,1,2,0,2,5,1670684.26671348,5175006.99274722
10,4,1,2,6,13,2318781.29498992,10526758.520333199
10,0,1,2,4,7,1874794.31984983,6191838.25118642
39,0,0,1,0,1,1585453.40093719,1853114.84903535
37,2,3,2,4,11,2119400.16160107,4960817.75365966
13,2,2,0,0,4,1538131.22860903,3129870.53508596
18,6,3,0,1,10,2049222.16949166,7951454.50568613
23,2,1,1,2,6,1212194.07336261,4757423.77072105
11,3,0,0,5,8,1774873.11424754,5220222.73259189
27,2,3,0,4,9,1784648.57713423,7504299.97257636
20,0,0,1,5,6,1192843.96234829,3427726.67186079
38,4,1,2,7,14,2400436.64785773,3863196.20744077
10,0,1,2,1,4,1407922.70592712,1748050.71745073
10,2,2,0,3,7,1355703.75840934,4744756.49542687
29,1,1,0,7,9,1623184.97188819,6730758.61488257
27,4,3,0,0,7,1885976.03329472,5863776.17302702
36,3,2,1,2,8,1658185.48800296,4998853.04816947
26,0,3,0,4,7,1879630.11816814,5446949.53760882
34,0,2,1,4,7,1397875.82850822,6328091.18070916
10,3,3,2,2,10,1998968.78217272,7595465.46310297
22,4,1,2,2,9,2277591.54059683,4808563.24512129
13,0,2,0,0,2,974374.341313576,5870478.69266999
30,4,1,2,5,12,1885191.52133554,6065804.58611479
11,2,1,1,0,4,1466773.04550329,2159781.93682171
13,5,3,1,5,14,2407901.79827631,11882686.6171639
12,2,0,2,7,11,1560759.31198782,10382739.77279
18,4,3,0,7,14,2880783.43946286,5210789.46770925
11,6,2,1,4,13,2404656.12772036,4638805.74807141
35,0,3,2,5,10,2072980.1106904,7095585.7463529995
27,3,0,1,2,6,1654562.01183042,3627070.74895397
18,3,1,0,1,5,1185886.17786506,3322398.84486194
25,0,2,2,3,7,1490060.17811741,2063216.72504099
27,2,2,0,3,7,1647542.79191938,4225112.35450767
33,4,0,2,0,6,1113719.58413053,5551983.13504582
39,1,1,2,3,7,2008057.99206153,3077572.32000266
32,3,2,0,4,9,1517492.83756584,6154151.35910732
22,3,2,2,4,11,1718344.7204972,6543790.79630604
38,6,0,1,2,9,1938581.82815705,4091598.79280731
29,2,2,2,7,13,1725948.00810944,6385794.42761442
18,3,0,0,2,5,1922370.90956377,4811674.45833058
11,2,3,0,1,6,2067427.36580825,4690441.56443757
40,4,1,1,5,11,2071405.39990191,7533021.09145078
18,5,1,0,6,12,2092265.22907104,5668706.86388698
23,3,1,2,6,12,2668129.792061,7431409.93219239
29,3,3,1,5,12,2938028.17054737,5545763.37180722
38,2,3,0,0,5,1385124.3594167,4002712.55416694
37,1,1,0,7,9,2435556.6013872,6828403.52457455
16,3,1,0,6,10,2147934.92593996,6807585.07790381
33,3,1,0,2,6,1314021.51511637,4279705.22593949
21,1,0,0,4,5,1456256.98313295,3933211.43705939
27,3,2,0,1,6,1046075.68146855,5155872.3301469
21,2,1,0,3,6,1724889.79930607,3998372.77403548
12,6,0,0,3,9,2026608.01440076,5229224.03473689
24,5,1,0,2,8,2597526.24999892,5699581.83905451
26,3,1,0,1,5,1538732.35610305,5462543.01348112
36,5,3,2,6,16,2334255.95098391,11403894.6943102
30,0,1,1,2,4,1185110.67759601,4684669.29146884
23,6,3,2,0,11,2565316.01670022,6845487.83465085
19,2,1,1,0,4,1477182.09953477,4753981.7918394
30,3,2,2,6,13,2063586.74333747,5766826.6942272
32,0,2,0,6,8,2272074.13334659,5120177.51293084
14,1,2,0,0,3,1008033.53076483,1641858.63707147
17,0,1,2,7,10,1741683.12864293,8797205.76742116
15,4,1,2,5,12,2221080.15665895,7836317.468649601
27,3,1,0,5,9,2150146.13281957,7205807.08313715
40,1,3,1,0,5,1774370.03477415,6024521.610884099
29,5,0,2,0,7,1248548.55468339,8320500.29307871
22,1,2,0,7,10,1989859.41926573,7027524.52756645
15,6,1,0,4,11,2010566.05687994,8848624.92750463
39,3,2,2,1,8,2074376.709271,7321795.50480304
14,1,2,2,1,6,1486427.1200903999,4686919.63612715
24,6,0,2,1,9,1964361.92796696,8815006.52299316
24,1,1,2,5,9,2310715.90217389,6291250.25983879
28,0,3,1,1,5,1737597.8476756,1691796.2840965
17,2,1,2,4,9,2056135.55799832,3549629.21220897
26,5,0,1,0,6,1432250.09128976,4862076.91937756
40,3,0,2,7,12,2539360.96302466,7666323.86385498
13,4,2,1,1,8,1918466.54147159,3629167.58528887
10,6,0,0,3,9,1706627.4701366,3119761.30216488
25,4,2,1,4,11,1859470.45655943,9339209.72513788
18,3,0,0,0,3,1519208.08019306,1810483.81160847
33,1,2,1,0,4,1395884.62384484,2878968.58199578
20,4,3,0,3,10,2666172.63711366,6584960.54345299
30,0,0,0,4,4,969874.19439275,3738616.63671372
36,4,1,1,5,11,1913130.45305291,5294481.05086554
13,6,3,2,4,15,3496985.52210032,3446145.58402852
17,4,0,0,5,9,2014792.98629293,7662695.60480277
21,4,3,2,7,16,3088520.15721868,8556469.86769365
21,1,3,0,7,11,2288758.66366582,8235805.6008955
34,6,3,2,3,14,1925142.45965528,6697986.31756344
40,5,2,0,3,10,1454595.56696673,9490917.0393234
23,5,0,2,0,7,1635974.03111422,5723345.80522785
20,4,3,2,3,12,1992257.06872279,7767108.15251803
38,3,1,1,3,8,1788762.16112728,851818.32195511
18,4,1,2,2,9,2297236.08218702,8519193.27286892
27,3,1,1,1,6,1641909.404151,5357363.9961455
22,6,0,2,0,8,1794806.77637146,4572248.163979099
30,2,2,2,4,10,2559390.40121573,6529664.01464377
18,5,1,1,2,9,1911146.8825279998,7493556.23146702
30,6,3,2,3,14,2414346.03367995,9895332.62061204
33,6,1,2,4,13,2337170.9799785,7441786.25266927
40,5,0,2,4,11,1996281.44616465,6454347.38340389
35,4,2,0,5,11,2767356.50924641,897439.494975353
23,5,0,2,1,8,2058695.77387111,5872666.99272217
19,2,1,0,5,8,2004787.53519583,5753067.75117393
27,4,1,1,5,11,1954692.86701076,7092315.29291546
30,2,2,0,7,11,2420850.10160655,5514264.97615176
27,4,0,2,1,7,1391424.97143024,3010068.42480476
12,0,1,0,1,2,976436.5669969509,5701964.99722094
35,3,2,0,0,5,1773131.85293087,3600351.98933346
27,6,0,0,2,8,1701605.69068295,7904089.53429215
36,2,0,0,7,9,1856781.32443182,6758302.32436892
25,1,1,0,6,8,1453102.50145688,4087515.03806592
27,1,3,2,5,11,1482810.19461395,7080758.69844823
12,5,1,0,0,6,1984894.46867992,5348831.26718218
39,2,3,0,1,6,1773804.37176089,6014266.77971552
28,2,0,1,1,4,1512990.00532752,3422955.72287571
39,1,0,1,5,7,1459445.53671663,7396508.33264786
32,4,0,1,7,12,1879724.98699314,2820432.06762745
16,3,2,2,6,13,2127862.70634208,5684302.97838275
34,0,0,1,1,2,1033440.38078068,3948927.83721296
17,4,1,2,1,8,1494081.47261434,8551843.38597469
28,4,0,0,5,9,1976848.59628118,2975077.25490274
38,0,2,1,7,10,2215014.18315279,7474997.67031327
16,1,3,2,3,9,2118568.38947147,4758112.63225526
36,3,3,0,7,13,2369325.32353158,7772606.05279096
12,3,3,0,3,9,1900849.85880529,2020233.49227897
22,6,0,1,0,7,1637864.70788805,7640983.919276699
37,5,3,0,5,13,2532595.11518167,8872935.08204201
39,2,1,2,2,7,1687469.32777099,5166212.310685201
37,0,3,0,2,5,1486997.69731025,2639838.30732359
27,0,1,1,1,3,1346221.98137777,1665721.59794228
36,4,3,1,1,9,2379787.50873836,10405542.3091862
25,3,2,1,6,12,2710886.41218606,4313639.64897634
20,5,2,1,2,10,1883750.55738995,5135230.40544877
11,2,0,0,0,2,1009284.57871939,5002883.99315986
29,0,3,1,3,7,1829895.74426756,6033847.34474822
22,0,0,2,6,8,1409771.72415126,2623373.52034035
16,3,1,1,2,7,2045342.34225027,4548766.17516791
39,3,3,2,1,9,1664987.63807107,4083557.72295728
36,4,2,2,5,13,2755130.74883274,6730436.9270851
21,4,2,0,3,9,1750500.8533709,6419585.83319469
18,2,1,0,3,6,1714370.7015802,5265776.79719484
15,0,2,1,5,8,1354484.83676586,5818955.57885533
21,3,2,2,5,12,2007380.08977997,7579508.22142763
39,2,1,1,7,11,1798418.85397323,5985596.57090318
37,1,2,1,2,6,1319317.13550101,6153278.07479369
27,6,1,2,1,10,2090161.5489073002,8297123.34615281
27,0,2,2,3,7,1566083.87643915,5898465.75609016
35,5,3,1,0,9,2104888.3003211003,2337393.20322815
34,4,0,0,5,9,2270844.78078767,6892351.41457918
28,4,0,0,2,6,1316852.44654884,4980323.28630814
13,1,1,1,2,5,1055985.17917513,2442524.88152712
27,4,2,2,6,14,2884899.03686739,3704596.20083836
32,5,3,0,6,14,1943001.10032147,4278870.33213732
40,6,1,2,0,9,1887700.28277128,5501846.29449472
34,4,3,2,6,15,2114841.50757401,9085976.50632137
27,4,1,0,2,7,1445608.49291693,5972093.20765147
14,4,3,2,1,10,1999885.46403065,6435442.29157787
36,4,3,1,4,12,2194230.78014536,7677911.53784152
28,3,2,2,1,8,1542969.9867523,6433223.95781452
29,1,2,2,2,7,1935021.2585794,6945086.99773035
10,5,2,2,7,16,2536493.3669576,5169072.73288325
18,2,0,1,1,4,1524663.60438709,6256665.90079212
10,6,2,1,0,9,2039057.64321005,4892710.80817462
19,4,2,0,4,10,2485252.41456066,5800519.17770171
36,0,0,2,3,5,1327698.84605588,5165198.58565403
12,5,1,1,2,9,1426346.22259448,7413930.07698195
36,3,2,2,0,7,1660406.61453656,2765149.91163551
23,2,0,2,6,10,1787337.19913219,7150573.01771221
29,4,0,1,0,5,1617601.93506713,2889963.29858591
28,2,3,1,4,10,2034109.30797233,4668726.99164655
39,2,2,0,0,4,918319.0912560909,4747759.17579121
27,5,3,2,7,17,3372800.00791895,5008314.83682097
35,5,3,0,1,9,2226751.97702008,7208767.5338791
21,2,3,0,2,7,976533.674819619,5892069.469089299
28,5,2,2,1,10,2123302.79885079,4653417.04189134
34,6,0,0,4,10,2296653.36686046,6445542.36906377
38,2,3,2,7,14,1862606.78868662,8545216.44608731
15,3,2,1,4,10,2129745.52275877,4127371.13318769
18,3,2,1,0,6,1479326.60228999,6456064.8660995
37,0,2,1,4,7,1884545.34529926,5281475.29801718
35,1,2,1,4,8,1763487.50406071,3111759.08335888
12,2,3,1,1,7,1476691.40789591,4460724.88876342
37,6,3,2,3,14,2057010.8984534,7817728.18847912
26,1,0,1,0,2,1449923.03877259,3144735.77103696
34,4,1,1,5,11,2320675.58432885,7601574.86220568
12,6,2,0,5,13,1805380.40880521,8386683.22384056
35,2,2,2,5,11,2790546.30608142,7001006.41506141
31,5,2,2,2,11,1610764.08918851,5388167.67574054
40,2,3,1,3,9,1352588.28112193,8193872.60091171
19,5,3,0,2,10,1646947.56762763,4456233.22005136
40,1,3,0,3,7,1647682.03608602,4470962.91425471
11,3,1,0,2,6,1500599.00009824,3679913.09722064
33,4,1,1,6,12,2455688.69704394,4530281.67310057
18,3,2,1,7,13,2233099.58829369,7075679.3831258
25,5,0,1,1,7,1829427.15012278,3552399.36334782
37,2,1,1,4,8,1328068.56718567,6799113.27043643
35,0,0,0,6,6,2018422.4308153,7143634.0499567
39,6,0,2,1,9,1878638.98065293,7628650.64008811
26,2,3,2,2,9,2202136.98314101,6607386.11170406
30,1,3,1,0,5,1694149.02904134,5278632.92451442
11,6,3,2,1,12,2155824.51745628,5671998.60711282
22,6,3,2,0,11,2311489.57899862,7038791.76907625
10,4,3,2,1,10,2306139.29995353,5632309.22710119
28,6,2,0,2,10,2195196.09380218,7845537.78931235
33,0,2,1,3,6,1900101.36797501,4125331.21342808
24,6,2,2,5,15,2201646.6716477,1454553.86738841
38,6,0,0,3,9,1997822.59378193,6274911.2676190995
37,3,2,0,7,12,2174855.04907426,8189161.24427292
31,5,1,2,4,12,2367588.44840569,7342410.961630001
24,4,3,0,7,14,1360725.91881049,7387662.61831713
17,4,1,0,2,7,1533397.726385,2594456.34642582
29,2,1,1,4,8,1552930.21603844,8526519.2392568
39,0,2,2,0,4,1627101.21870408,4632238.97672559
18,5,2,2,6,15,2649636.19823856,6577932.43266507
30,2,0,1,0,3,1262303.67301749,1106373.79830551
36,1,0,2,0,3,1409030.4039562,3880437.42231834
39,4,1,0,7,12,1853492.62677867,6148263.75955342
18,0,0,2,3,5,1837104.33819318,6095302.70114877
32,4,2,1,5,12,2245662.71487296,8210101.75671491
26,5,0,1,3,9,1670452.45556478,2621636.87670345
32,2,3,0,7,12,2561976.35148699,8778038.19656246
11,2,2,2,7,13,2641033.52060885,7672561.94309764
17,3,1,2,4,10,2416280.25594961,6270498.70428853
38,0,1,0,5,6,1685353.61674244,5319557.15359403
32,0,1,2,6,9,1831786.94301719,4134056.01764026
18,6,2,2,1,11,2306567.5217278,7167620.88668621
11,0,0,0,6,6,1864745.99462927,6108866.68720169
28,5,3,0,1,9,1961505.23003406,3667011.78394874
35,4,0,2,3,9,1907144.32261075,8590819.35954977
20,1,2,1,0,4,1076214.17545774,2815765.21315535
34,5,0,0,7,12,1224513.80758514,7011042.88573942
19,1,3,0,5,9,1823187.59744426,2925321.00813257
14,1,3,0,7,11,2354524.82712782,3295733.42384693
19,1,0,0,1,2,825147.968011223,4398700.34256885
28,1,3,2,5,11,1815964.75229576,9448682.96449408
39,5,1,0,6,12,2178202.91607159,3902259.69957941
11,0,0,1,4,5,1459065.84497794,3916378.51106755
19,0,0,2,4,6,1537617.12797687,5631831.00390661
40,0,0,0,5,5,1555790.28411714,3969600.58307127
37,6,1,0,1,8,1543994.36534442,2372248.20201654
31,3,1,0,3,7,1551034.66968997,6311596.7969266
18,4,0,1,1,6,2110308.08825651,4499132.76377436
27,3,1,0,0,4,1393126.70004792,3637659.06970669
27,3,1,2,0,6,1698996.26130624,3529022.34677144
22,6,1,2,6,15,2474817.77441929,9218155.86763647
23,1,3,2,3,9,1984155.47445255,5067791.98644419
22,4,3,1,2,10,1826589.15382683,6529174.72886248
33,6,0,0,1,7,1716131.53822195,6992671.88866314
15,0,2,2,4,8,1998179.07159792,5472483.81254927
11,4,1,2,1,8,1892419.53396862,6888546.77781371
21,6,3,0,5,14,2978730.02741078,8329046.06840604
15,5,2,0,1,8,2224529.86113517,6075674.66849565
18,4,1,2,7,14,2973300.06496209,5195049.03786099
22,6,3,1,5,15,2433914.39173155,4979746.85917437
17,1,2,2,0,5,1553446.00327426,4623449.23514399
32,3,0,2,6,11,1819074.88455208,5962516.27548898
23,5,2,0,0,7,1431786.05504732,5133568.46315633
36,4,0,2,1,7,1679795.23092762,6381117.632054401
26,6,2,2,6,16,3048290.35182291,10049699.123189
11,1,2,2,2,7,1938972.96182096,2852439.36073612
10,2,1,2,7,12,2647222.73099144,6103758.45168529
12,2,1,1,3,7,1520717.33005834,4939696.54761513
40,1,2,2,3,8,1568276.17575751,3697568.00554894
33,1,3,0,4,8,2046194.1764910999,5588967.09453222
31,6,3,0,0,9,1742981.8314874,7059379.54684566
25,2,3,0,3,8,1224096.57232408,6721300.91161287
33,2,0,0,0,2,1196546.73923998,5167553.0933182
18,1,2,0,5,8,1522321.19451748,7226515.36155062
39,3,2,2,3,10,2328768.43880298,3440668.18742203
36,2,0,1,7,10,2141496.06321026,5644728.31089192
23,1,0,1,7,9,1634535.56757581,5958676.75696377
40,6,1,1,2,10,1859707.48041344,5840442.84516116
21,3,1,1,0,5,1513176.34197266,5399874.18627262
12,4,1,2,1,8,1638740.21315508,7703992.13818101
13,1,2,1,6,10,1718459.64111164,10044202.152986
32,3,0,1,3,7,1687598.81653755,5978880.44752208
32,6,2,1,0,9,1977743.20028604,2041894.06782789
17,6,0,1,1,8,1921984.89710973,5134946.24961093
31,0,1,0,7,8,1598960.37920845,818569.622625561
30,2,1,0,3,6,1697197.43671951,3189921.99988901
38,2,0,0,7,9,1522231.20587532,7239996.96117318
25,4,1,2,0,7,1646644.61268625,6423215.00744953
13,4,3,0,7,14,2328999.81218879,3112947.30353104
39,6,3,0,5,14,2591772.04393928,5859116.86397284
10,2,2,1,5,10,1859371.80034575,3586205.14387872
32,1,1,1,1,4,1641959.4688940002,6148975.33810193
21,0,0,1,2,3,1378714.52601425,4476150.66546461
40,3,0,0,7,10,2311138.41288972,4094499.9745981004
11,1,3,1,3,8,1966502.0586351003,4111219.08649074
38,1,0,1,4,6,1432312.71282477,2301138.37487341
34,0,2,2,0,4,1272803.13806618,4428796.36953085
21,3,1,0,3,7,1529392.08327937,6911350.26742524
40,3,0,2,5,10,2075376.97038073,3482182.82933656
31,4,3,0,6,13,2083571.28548959,6690679.65145913
16,0,0,2,2,4,1538407.66060338,3309037.74138211
22,1,2,0,6,9,1644525.68428124,7168542.92237562
11,0,2,0,1,3,1192115.48770989,4160116.68678699
26,0,2,0,7,9,1867812.52147445,5195486.73979137
30,3,0,0,4,7,1791142.80376317,7036872.89520028
40,0,1,1,0,2,953736.51010712,3065075.86426877
21,0,3,0,2,5,1725600.84056207,1383586.6708812
23,6,2,0,7,15,2191634.8536641,10277005.0267377
24,1,3,1,0,5,1582951.19249737,4862182.83084433
32,1,1,2,3,7,1456519.48572701,6807000.52233361
34,3,3,2,7,15,2273709.27689449,8069755.96021806
25,2,3,0,2,7,1813723.89621949,4728451.01534751
22,5,1,1,5,12,2263420.72726412,4498565.0986252995
38,2,2,0,5,9,1837629.03768278,3716080.4184021004
13,1,1,0,6,8,1567571.17165343,4466298.72922608
21,4,2,0,0,6,1799134.9138763,2642722.01708919
13,6,1,0,6,13,3355554.14428144,8061860.24862611
31,5,3,1,2,11,1664193.17075238,8951371.33320867
39,4,1,2,7,14,2314041.1846419,8476408.71067931
27,6,2,0,0,8,1872489.19140242,7345404.09943957
15,2,1,1,0,4,1073608.90618992,3534015.63550986
32,1,3,0,5,9,1757487.8209867,5979393.26304601
31,6,1,2,1,10,2790049.52919157,2114097.3465811
23,1,2,0,3,6,1536159.06266949,2472252.32306525
15,5,0,0,6,11,2134016.13046476,3660526.50397328
17,5,3,1,5,14,2451278.40109223,4014490.92659677
34,4,0,0,4,8,1715551.88895503,4500530.12701699
19,0,1,2,2,5,1436768.29982563,2913811.42661993
38,6,2,2,3,13,1872487.77519351,4941168.37505246
36,0,2,1,7,10,2005923.08171074,5686048.49766422
11,3,0,0,1,4,1435747.10153416,3723089.86268775
22,0,1,2,4,7,1776358.78588815,5215988.89245474
10,3,2,0,6,11,2310872.10345952,7160912.27660719
19,1,3,2,6,12,2337965.75015404,7933536.91797014
40,2,2,1,5,10,2254235.38386883,5226663.08631235
29,1,3,2,3,9,1948224.64708827,6624967.06071422
35,5,2,2,3,12,3085015.51296606,3110029.16187877
19,5,2,0,0,7,1697501.11440067,3837290.48594383
33,3,3,0,1,7,1444582.77377646,5382426.82696989
10,6,0,1,3,10,1704984.14245708,8438335.00935867
35,6,2,0,0,8,1774023.54691364,3557548.65132378
31,6,2,1,0,9,1463159.04321255,6797486.14902238
30,0,2,2,3,7,1517470.34475664,6193021.62211187
29,0,2,0,2,4,1347628.33590879,5930625.09339695
14,0,3,2,3,8,1823423.51788897,4861101.53618458
16,3,0,2,3,8,1699150.26152715,3462742.94144114
21,3,1,0,1,5,1579337.08096418,3434459.03021885
14,5,2,1,4,12,2358527.85959859,6372760.80027204
13,4,3,0,6,13,2953350.69966879,4201492.88221612
29,1,1,1,7,10,1228350.72674046,5998147.4138953
39,4,3,2,3,12,1812647.5460812,5498401.08188069
29,5,3,1,6,15,1710573.97765069,5155061.91274087
11,1,2,2,1,6,1759535.39891264,5455943.88270826
28,3,1,0,4,8,1734715.46248882,4695073.50711768
24,0,2,2,4,8,1865257.3571646,7642573.66414026
11,6,1,0,2,9,1777538.07702941,7379941.52376817
14,5,3,1,7,16,2713908.65744158,5314252.45361073
23,6,2,2,3,13,2060981.50376095,8060405.47657248
33,1,1,0,3,5,1784244.37072855,1315992.30670008
13,2,3,0,1,6,1710023.87697752,6248196.45257826
30,2,0,2,1,5,1759659.56391663,6420063.17162262
36,1,0,0,7,8,1375492.94816573,4260741.94674209
11,0,1,0,5,6,1377911.56649384,3465325.16922005
11,0,1,1,1,3,1421218.61985358,4510764.61565331
16,1,2,0,1,4,1393371.13532454,7609912.40443105
40,6,0,0,7,13,3084468.5929882005,6221529.31801648
39,0,2,0,6,8,1758514.30031576,5927570.45681252
37,3,0,2,0,5,1336578.50710416,2949907.37747611
24,4,2,1,7,14,2381503.76389556,5649650.48395422
11,2,2,0,3,7,1820383.40873204,5945863.89870929
18,4,2,0,0,6,1028906.451289,4131362.53221661
16,1,3,2,3,9,1079773.45027294,8905191.70495705
16,0,3,0,2,5,1999230.70728812,3639335.53592615
23,4,3,1,2,10,1831158.78772148,5582687.39378222
35,2,3,1,1,7,1708892.01351042,5028313.35550531
23,3,0,0,6,9,2061135.82296157,5442728.47784997
28,6,0,0,7,13,2558122.26697817,6031920.82616562
18,2,1,0,5,8,1755620.24553773,9144751.42447101
37,2,2,2,0,6,1557814.91402668,3788414.6358907004
31,6,1,0,3,10,2214083.2710223,6708668.38807132
24,4,2,0,1,7,1628243.88213816,6403201.411299
37,1,1,0,2,4,1177749.92438335,3266149.95142313
24,4,0,2,0,6,1756056.17080576,4564423.52669865
37,2,3,0,2,7,1603219.28564294,7060112.27142046
11,6,2,0,7,15,3244192.6726363,9535789.56096162
27,2,3,0,4,9,1686233.25069894,5734809.28302444
23,4,1,1,6,12,2594770.13267064,4615691.68710542
22,4,2,2,3,11,1711689.49158807,3892152.43205319
20,5,3,1,6,15,2333250.93334827,8426345.25210039
22,4,3,0,5,12,2240333.40360254,1906133.53010994
20,5,0,0,6,11,1929858.60689684,7830156.85744215
13,3,0,1,0,4,1417511.62779967,4789326.41517218
28,0,0,0,6,6,1563478.29847084,7065764.03066599
17,4,2,2,4,12,2169720.93746508,4918432.7853119
25,4,1,0,1,6,1168388.90518931,5657827.74783129
38,4,3,1,6,14,3179392.56276691,6988370.56630514
35,5,3,0,6,14,2857298.33098984,10248148.497906901
17,4,2,0,1,7,1711662.24059276,5386363.44094988
39,6,3,0,5,14,2409242.37665515,8863349.90177442
12,2,0,0,2,4,1292831.24270413,2461934.35706694
17,1,3,2,1,7,1856108.90079338,3839399.38195803
15,5,0,2,3,10,2109357.93506691,7542341.63264002
14,0,0,0,3,3,1439779.788443,4042612.71344089
10,5,1,2,5,13,1678605.81092379,7424586.20358311
39,5,3,2,0,10,1735041.14587347,2245934.839088
32,2,1,2,5,10,1653138.82834265,9274573.12568117
33,6,0,0,6,12,2343222.33880532,7831738.68054694
16,4,2,1,7,14,2171989.12684934,9102393.85276819
34,0,3,0,7,10,1937747.12791976,7152515.92068941
28,2,0,2,3,7,1812761.25399247,4577314.29277326
10,2,2,1,7,12,1870540.72154401,6944426.53495366
19,2,0,0,5,7,2098725.32010113,4244202.74980321
23,5,3,1,4,13,2153011.14841349,6923411.57199868
34,5,2,1,7,15,1938052.63941377,9818305.82995594
18,5,3,0,2,10,2095002.01484164,8030470.08676809
18,5,1,0,4,10,2264046.7023807005,6375613.13067005
18,0,2,2,0,4,1128947.13265624,5352125.85988249
19,3,1,0,1,5,1646249.99866466,4496620.70549133
11,3,1,2,0,6,1428933.80496501,4644169.97715874
33,4,2,0,6,12,2315911.03558264,5807139.5306396
14,5,3,1,6,15,2423332.40773305,3444797.57770073
28,1,2,2,3,8,2103589.53109851,6741607.55775414
25,2,1,2,4,9,1938730.38947026,4977378.44731733
28,6,0,1,7,14,2050321.85055725,9054125.79744096
35,0,3,1,3,7,1959696.65703272,5349210.37834028
11,5,3,2,7,17,3225258.03195283,10246331.2743218
34,3,3,0,4,10,1253047.56986002,5569128.25186808
37,2,1,1,7,11,1952854.62239131,4576445.52380407
33,4,0,1,0,5,1194695.93927543,2987446.06554782
40,5,1,1,2,9,1943899.16815523,6023898.67636167
23,3,1,0,5,9,1898757.11344281,9106111.26250314
11,6,3,2,4,15,2470102.28167221,4507436.26707423
16,1,1,0,2,4,1413220.04229689,2101113.94201198
24,2,3,1,4,10,2286770.80183187,7717969.81355345
24,1,3,0,1,5,1025304.22589851,2653941.99829924
27,0,2,2,2,6,1504334.52943795,4407571.36860476
37,1,1,0,5,7,1759091.38843724,180049.78240654603
11,4,0,2,7,13,3024423.78690651,5829762.06620403
33,3,3,0,2,8,1925882.12291794,5241271.88062959
18,1,3,1,4,9,1921616.96317192,4094690.54752748
30,6,0,1,2,9,1304226.32532274,6614615.87390764
21,0,1,0,5,6,1440032.51279896,3901161.42270834
37,2,3,0,1,6,1758213.05934309,4860789.1521197995
19,0,3,2,3,8,2025722.69705728,6343006.66862445
27,1,0,1,0,2,1443727.75892261,4778135.85106372
20,3,1,2,7,13,2460106.64922667,8716636.15755791
10,0,2,2,7,11,1621403.27847694,7817319.37363489
18,6,3,1,5,15,2729405.38170337,5067676.72343373
26,4,2,2,6,14,3034550.63182825,5601662.38979104
25,6,3,1,5,15,3417782.25528826,8598562.0945394
37,6,1,2,2,11,2413370.82047593,5855869.822692299
27,3,2,0,6,11,1920721.59686885,5350796.49739262
12,3,3,2,6,14,2024966.88645362,9692240.00028787
14,1,0,0,7,8,1900563.81977129,5714189.76698078
20,2,1,2,1,6,1831415.3445328,4109377.50502062
33,4,2,2,7,15,2674803.34098951,8023582.16064355
33,3,1,0,4,8,1809348.98270194,7010338.36709527
35,3,2,0,2,7,2213225.66186577,4362596.53970079
34,5,1,1,1,8,1705737.13187554,5098407.21651065
36,3,2,1,5,11,1656685.52088523,4554874.72118719
24,0,2,2,5,9,1372908.36320566,6006547.70723284
14,4,3,0,1,8,1781275.63440944,5338998.79090321
16,4,3,0,2,9,2115526.16016751,4114676.04729253
19,1,3,1,6,11,2297575.5417130003,5118334.49049007
29,3,0,0,1,4,1305410.9201523,2541422.48815183
24,3,2,2,7,14,2578246.36859867,6709763.71798255
36,6,2,2,4,14,2371092.68269138,11187644.613769699
32,5,2,0,7,14,2501571.64187019,8493966.296574099
34,4,0,1,0,5,1508570.30125114,7527391.53842409
13,3,3,0,3,9,1819498.3330203,2181151.43402792
35,0,2,0,3,5,1401052.98208911,5248966.05887554
37,1,2,0,0,3,1207380.14036617,4058731.20109504
15,6,0,0,1,7,1662394.89277826,10715580.9914356
11,0,2,0,5,7,1811326.44863987,2425770.93337734
14,6,1,0,7,14,2958161.40285941,6967171.60208376
30,6,3,2,5,16,2004197.89323884,6533915.07022536
39,5,2,1,3,11,2472872.67012764,8581952.52689341
11,6,0,2,2,10,1369093.91817631,5784037.63490911
28,1,3,1,4,9,1803572.67384582,7013508.791888
17,4,2,2,6,14,1980590.90924262,5899821.16978672
31,4,1,0,5,10,2147434.27050173,5734530.98904397
22,6,2,0,5,13,2853948.38768505,4105951.03512653
33,3,3,2,7,15,2622516.24797568,10155635.1711765
15,1,3,1,2,7,1748450.57962979,4747531.01940621
38,5,0,1,5,11,2187571.56128063,6413116.21207871
24,4,0,1,0,5,1016935.10938506,5552496.39015217
22,5,1,2,5,13,2093506.40739305,8977598.71570647
35,1,0,0,7,8,1977798.52113186,5121345.54890553
28,5,2,2,7,16,3130022.33303083,10494608.316539
31,6,1,1,2,10,1712709.84913729,7649107.61181668
21,1,3,0,1,5,1320290.7217342,3548687.50450274
40,2,1,2,7,12,2407928.25747982,7293105.82524139
35,6,2,0,0,8,1888383.11740074,2721352.8008095003
27,6,0,1,1,8,1605232.58816081,4061404.29712169
40,5,2,2,2,11,2120354.72770968,6069206.2447844
10,0,2,0,3,5,1836676.84929904,3620658.32988347
12,1,1,0,0,2,1252628.76498527,2709024.95978652
35,0,2,1,0,3,1219204.34014838,5136332.18911892
12,2,0,2,4,8,1863859.63924328,4651349.08490005
29,0,0,0,7,7,1556242.31453936,4660251.57078564
24,4,1,0,5,10,2146519.37177835,5776591.63563702
35,5,0,2,6,13,2689724.09854037,8491759.28402181
35,3,3,0,0,6,1670942.84811985,2077267.37907205
25,1,1,1,0,3,1037138.68756513,2429263.43505378
29,5,2,1,1,9,2214377.40276147,5041440.46527935
34,3,2,0,5,10,1862240.35748987,7800155.06279676
20,5,2,1,7,15,3249836.78195743,9293497.25147755
13,0,3,0,2,5,1316440.89806871,2999206.24266356
18,3,0,0,1,4,1928320.71882865,4075093.36199812
33,4,1,1,1,7,1922180.48135139,6076864.12368412
40,5,2,1,5,13,2232618.13152327,6592709.50956021
30,0,1,2,4,7,1836477.09804975,4610448.58370787
26,0,1,0,3,4,1388219.55281361,6717652.12180435
35,5,0,1,6,12,3042825.07363151,6891351.72941654
40,6,3,1,4,14,2701785.16301431,6210801.55369371
31,3,1,0,6,10,1769533.23884415,7948418.43962382
12,0,3,1,6,10,2132459.68955625,7420934.72832746
32,0,0,1,1,2,1491094.9201812001,5646883.7520181
26,5,1,1,5,12,1425070.91002583,8998433.47746803
18,3,1,0,3,7,2004988.8920281,6737934.92204976
26,4,1,2,0,7,1872618.40048571,4099114.44363514
35,1,0,0,3,4,1252953.97100979,5513264.13949558
33,0,3,0,7,10,1795291.08160947,9749501.80133775
19,6,0,2,3,11,2355319.5322861,5586164.8371501
25,6,2,2,1,11,1740880.54564155,6370580.49963396
22,4,1,0,5,10,2035492.71841671,5439668.90539793
18,3,0,1,4,8,1689135.1722641,2009640.33592959
16,3,1,2,0,6,1472985.23618512,5338829.33988037
38,2,1,0,2,5,1740089.37264746,3386063.25598941
17,4,0,1,2,7,1869292.63921881,5382747.06281339
37,0,0,2,7,9,2248660.96266875,3979529.27879885
37,5,3,2,5,15,2929407.0235538,8186702.64655569
24,5,0,2,3,10,1825724.08517038,8398244.24788732
35,1,1,2,0,4,1368390.21893933,6217677.29283734
24,0,2,2,1,5,1244420.26049632,3554217.37429353
22,0,0,2,6,8,1660541.94529836,4079370.32172804
36,2,2,1,5,10,2026179.01044675,6834054.58809977
28,1,0,2,3,6,1824543.65723533,6376010.44372213
30,1,2,2,4,9,1724893.48245876,6915139.55034262
24,5,2,0,2,9,2371992.37381994,2371992.37381994
36,3,2,2,4,11,2796126.13101084,6528112.46277278
27,5,2,2,6,15,1802343.10536904,5692611.46372622
32,0,3,0,5,8,2010044.96595197,7956579.33766773
39,0,1,2,1,4,912864.290339362,1617328.08611198
22,1,2,1,1,5,1480899.39826899,3504182.25687599
17,5,0,1,0,6,1757071.53672212,6088897.77480724
34,5,1,2,2,10,1738099.59987714,6255994.46300823
35,4,2,1,5,12,2097980.58374371,8738290.88992899
24,6,3,1,6,16,3217279.54230236,9958409.12904455
32,6,3,1,4,14,3138493.30487118,6313260.53162743
11,1,2,0,6,9,1901249.00513931,6113488.68723405
31,1,3,0,3,7,1481176.14275724,725011.957686562
13,0,2,0,7,9,2679818.75216424,9550052.53138258
25,5,1,1,7,14,2714995.12673455,6721112.26244054
29,5,2,1,2,10,1928449.44882214,4647652.00655065
22,6,1,1,6,14,2105092.25958026,5122690.10424486
36,0,3,0,4,7,1930513.95420036,5823522.75258705
39,6,0,0,0,6,1510452.30504886,2725806.99938303
29,2,0,2,6,10,2110193.70562327,6216501.96706478
26,3,2,2,3,10,1930384.89265707,5956442.23263279
21,5,2,0,4,11,1913377.24353009,6424333.75702732
40,0,0,1,2,3,1530666.61432547,3918564.2802919997
31,3,1,2,3,9,1747475.62057063,4924498.68017078
21,4,0,2,7,13,2894372.93866609,6536896.70075721
35,3,0,1,7,11,1719702.75899166,4465059.09156403
27,0,2,1,0,3,1104748.28732016,4303324.8698629
37,1,3,2,7,13,2248435.11324133,3127259.55185989
20,0,2,2,3,7,1513152.82882993,5470141.81062282
17,6,3,1,3,13,2499388.46899796,5374770.32557506
29,6,1,1,2,10,2237765.58455952,8555855.51441557
16,0,3,2,6,11,1326827.1400514,6674210.81987031
22,6,2,1,1,10,2073740.99863396,7671486.48953824
24,5,3,1,6,15,2517948.91965503,5182345.63991809
31,4,0,2,7,13,2092356.75260122,7910384.39468768
35,5,1,2,1,9,1892278.13019079,4613565.14496859
12,2,1,0,4,7,1402752.34630446,6630101.36167585
26,2,3,0,1,6,1918766.00474254,2974104.21681485
21,4,2,1,0,7,1902090.39279184,4622208.14101618
11,0,1,0,3,4,1799166.31250596,3138077.16027771
15,5,3,1,0,9,1947043.90952405,4146244.61717846
14,1,0,2,6,9,1530602.02190605,6154890.2938271
22,0,1,0,6,7,1553018.73611877,5431002.83858265
36,2,2,0,0,4,1011993.12948716,4339901.48358353
11,1,1,1,4,7,1793833.8924178001,3855058.89581683
40,5,0,1,0,6,2073422.34009068,4490375.87801047
30,3,2,1,5,11,1827314.85173867,5757807.37311067
11,4,0,2,4,10,2141551.58225046,7350284.82229936
37,1,1,2,0,4,1789368.85306716,5421679.23761265
28,4,1,2,3,10,1704622.9353318,3420612.25090003
17,2,2,0,2,6,1734576.22649901,6547154.57674194
20,0,3,0,1,4,1271295.66265186,4265921.37698168
16,5,1,1,6,13,2028171.15060321,4000702.43145233
40,4,2,0,7,13,2562518.31358814,6289610.73710586
25,4,2,1,3,10,1783869.16414792,1635476.6017236
25,0,3,0,0,3,1241170.43932604,4722295.12418552
31,5,3,1,4,13,2097404.45994184,5124495.25784434
17,0,3,0,5,8,1532177.37625412,5764067.38722525
21,3,1,1,6,11,1311940.37719484,4262339.70163347
39,5,1,1,1,8,1956221.3256040001,4915655.57349099
24,3,3,2,4,12,2318027.08431924,5427427.81890478
20,2,0,0,1,3,1057891.16792639,5436448.97038478
36,2,0,1,6,9,1230968.73140037,4030450.56088041
19,2,3,2,6,13,1807271.99780362,6061215.06161507
17,6,1,0,2,9,1722940.72593716,10051131.850152802
14,5,3,0,6,14,2492637.11112227,6120818.04340392
16,1,3,0,5,9,2068605.31493744,4080340.81887505
26,3,1,0,5,9,2113714.05362732,8799585.40567814
14,5,2,1,3,11,1950710.48662016,4423153.01199385
30,1,0,0,7,8,2098553.40197927,7128278.87617954
24,5,3,2,2,12,2126362.2323124,7204940.02453994
31,2,0,0,4,6,1477731.76932661,1404169.59696564
17,5,3,0,6,14,2109950.04082499,9162448.18670062
15,0,3,2,3,8,1984699.39590955,6922610.61780492
25,4,0,0,6,10,1923895.78706213,8356691.93443355
33,1,3,1,4,9,2001025.21335147,5110873.22857533
40,1,3,0,0,4,1317706.98668791,6397669.06597169
34,4,3,2,3,12,2148233.49060585,11715997.3153295
25,4,2,2,4,12,1750977.61741235,6542219.001668
23,6,0,1,7,14,2435861.32663324,9190288.603585199
37,5,2,2,4,13,2114256.36141029,5634944.6290598
37,0,1,2,3,6,1958167.54693291,3061492.16672884
27,5,3,0,6,14,2499515.47776685,7700122.67655282
16,2,0,2,7,11,2869164.12237146,7662774.21379511
23,6,0,2,2,10,2021572.45541997,4769371.17701766
38,2,2,2,3,9,1801462.82859503,7792081.94642666
17,2,1,0,5,8,1354073.05643756,6554772.68799406
36,1,1,0,4,6,1515924.93081033,3970843.05658612
40,5,1,2,7,15,2438950.85415011,6614060.36954238
23,0,0,0,5,5,1403910.72938312,3900328.24324698
26,0,2,2,0,4,1419858.31836483,4375535.72426917
36,3,1,2,0,6,1861823.71292013,6060973.79813389
29,2,2,0,6,10,1926000.37623388,5327663.45535746
22,1,1,1,0,3,1645838.29442336,6184798.84241466
27,6,0,2,3,11,1955033.61062992,6115150.0951714
33,2,2,1,2,7,1691597.5783926002,5593964.28889512
29,0,3,2,7,12,2557081.45523125,6673779.13593466
35,3,1,2,5,11,1562899.21168836,7702637.14241522
23,6,1,1,3,11,1797615.59558981,5692654.37279623
15,4,0,2,0,6,1651271.59367797,4430312.81419042
26,6,2,0,5,13,1561899.46655104,8553743.33325193
36,4,3,2,4,13,2365153.46593208,5461279.52902852
26,3,1,2,7,13,2125279.63542857,6860049.39567353
10,3,0,1,1,5,1306753.01709221,2198550.87517893
12,1,3,2,1,7,1312390.73682982,6106775.62535585
16,1,0,0,0,1,1076886.19703502,228568.878485605
17,0,3,2,0,5,1644762.99289624,5996231.23268809
32,6,1,0,6,13,2124707.05395641,1850800.22145897
39,4,2,1,2,9,2294011.10770314,2195667.41976172
27,6,3,0,5,14,1839861.55864737,7968759.638076801
12,6,3,0,4,13,2158955.52525466,5440596.21111034
21,4,0,2,5,11,2006067.03851253,6958358.82951538
35,3,0,0,4,7,1578839.42615008,5907426.07271113
31,4,3,2,6,15,1976238.08886716,9383143.59035788
19,3,0,2,4,9,1400004.86031328,6758474.97270682
12,0,3,0,7,10,1064550.20511967,6054155.61686062
29,2,0,2,4,8,1784465.11556416,4094553.61338861
37,2,0,0,6,8,1949806.30162712,5189713.83260195
19,4,0,0,0,4,1595310.30018159,5924051.60920234
10,6,2,2,2,12,1797954.44279792,5260019.70417294
13,1,1,0,5,7,1778247.45284878,5937528.61363609
12,6,2,0,5,13,2606738.42579793,6581592.92553954
21,5,1,2,7,15,2019513.42351285,4063150.45791021
12,1,2,0,5,8,1822341.79475333,5537967.00009892
19,4,1,2,3,10,1806941.21328459,5981201.81260984
10,0,1,2,3,6,2138425.67725125,3347190.51650031
20,3,3,0,3,9,1923883.0248218998,5861442.85457146
11,6,0,2,7,15,2526665.85785206,4757431.58600561
11,4,0,2,5,11,1549815.37851388,6407347.73086616
34,4,2,1,0,7,2033667.72243134,8030576.97958815
30,6,0,1,3,10,1142143.70379287,8242235.87852832
22,6,1,2,0,9,1837807.50586905,4189098.65944339
22,1,3,2,1,7,1744584.2661831002,4205507.08382521
36,0,2,1,3,6,1535582.64294926,3959735.87942271
23,4,0,1,1,6,1234948.14962728,3977923.60538955
28,1,1,1,3,6,1244559.63610206,6389974.14597015
16,4,2,0,1,7,1795305.09385487,4055959.59753206
13,3,0,1,3,7,1742829.11892157,5227428.30203179
26,0,0,1,5,6,1738713.92591023,5349377.31381995
11,4,2,0,3,9,1710674.97611073,4781914.647618701
16,4,1,2,7,14,2914458.76371537,6993337.80403724
35,4,3,0,3,10,2157688.3607127,4059119.37278723
28,5,0,0,0,5,1481563.53220449,3287259.1679337
25,5,2,0,3,10,1436889.72044974,6357834.31436449
29,1,1,2,5,9,2278246.85171787,7170964.14217337
15,1,3,0,0,4,1650918.00421298,5267555.23184793
27,0,3,2,5,10,1993652.06865258,9123538.8505666
40,3,0,1,5,9,1438180.55261118,5289711.71147335
15,2,0,0,6,8,1871413.12883384,5995472.34390682
11,6,1,0,2,9,2352340.08022923,2165473.86128588
29,6,0,0,6,12,2109978.86902598,6704809.91348665
14,4,3,1,6,14,3029018.69931399,2802722.12768793
23,5,2,2,0,9,2145616.2588786,8529359.21907339
16,5,1,2,7,15,2209625.7865917003,12071015.4065005
37,6,1,2,3,12,2273322.60350492,3149061.0133407996
34,6,1,1,3,11,1837246.19796356,8755062.87159412
28,5,1,1,4,11,2226384.07671713,5983902.47069934
14,3,2,0,2,7,2061183.65589871,497647.701947385
34,6,0,1,1,8,1924187.9873402999,4275896.46822459
33,2,1,0,3,6,2007324.77675281,5544896.72584903
10,6,3,0,4,13,2472497.43004335,8161149.6417931
33,1,2,1,7,11,1733975.19183247,2592876.32522284
26,2,2,0,5,9,1769118.68179234,7131407.69619572
10,3,0,0,5,8,1517924.6914748999,8112622.15178411
18,2,0,0,4,6,2384924.78673704,3239451.41421382
30,3,2,1,7,13,2381815.63911872,8589632.44089
40,0,0,1,3,4,1466027.66683706,2204295.65427798
25,5,0,0,7,12,2726870.62469248,6561427.45541272
27,6,0,1,6,13,2897666.3101462997,5218610.28472261
39,4,3,1,1,9,1733674.14760754,6868005.03369516
21,0,3,0,3,6,1448896.70139763,5706326.69074378
35,4,1,1,6,12,1617149.19498961,7722352.08814708
23,3,2,2,3,10,2584357.90370932,2602578.16351559
37,2,2,1,1,6,1811027.94435852,3521557.38913581
10,0,2,0,3,5,1840013.58107234,4911925.83486942
27,0,3,0,0,3,1118121.47917921,3839574.8919077995
28,6,2,2,4,14,2951320.68919217,8516336.36814419
35,4,3,2,2,11,2199009.06105267,8747037.97701787
23,3,1,0,3,7,1710132.72054874,4321588.15704702
19,5,3,0,7,15,3041987.24361651,5061622.0274433
21,4,1,2,3,10,2011633.007201,8625493.66242067
38,1,0,2,5,8,1883057.59525035,5427356.77102066
36,1,2,1,1,5,1197058.70767269,4229290.36162616
23,1,3,1,1,6,1609723.76733035,8248957.3356213
37,0,1,0,5,6,1520401.78540358,4843636.52192236
23,3,3,0,4,10,2354979.75164908,7673248.51302086
24,5,1,0,4,10,2395314.72447599,4194068.71063626
26,5,3,0,2,10,2398940.06857815,4395591.85946738
37,0,2,0,0,2,1262046.07056787,393390.65618873
37,4,3,0,4,11,2572536.55345221,3941300.99354614
18,1,0,2,6,9,2278005.60329887,10336305.2552858
28,4,0,1,4,9,2069262.82486006,6701814.0058470005
26,4,3,0,1,8,2273101.15992118,3241658.66594448
27,5,3,1,3,12,1704877.07001402,7365854.62070709
32,6,1,0,3,10,2159332.61738654,10222373.1050845
12,6,3,0,1,10,1944432.80110059,5995872.50763028
18,1,1,1,5,8,1414032.00427046,5031063.29922317
12,0,1,0,0,1,1002094.12168143,4591487.80378655
14,3,3,1,3,10,1977816.95805422,5914389.10029466
12,2,1,2,2,7,1958247.74310954,5875907.17998657
10,3,0,0,3,6,1551376.4109777,3984505.92026628
25,4,0,2,1,7,1769402.55786711,1508757.05835477
17,3,1,2,1,7,1791677.52143683,5406414.66055408
19,1,3,1,0,5,1536373.88748086,6698290.71855472
37,2,0,0,4,6,2065805.18906821,1082117.00653526
15,0,2,1,7,10,1830368.47861697,7194037.67881086
12,0,3,1,4,8,1605083.67764981,6036414.32274835
19,6,3,1,6,16,2560490.4444067995,6477555.40589907
23,4,0,0,5,9,1089487.18514535,3548434.67757265
33,5,1,1,3,10,1742362.10889645,8595723.56631434
27,2,1,0,0,3,832170.69885347,1911985.77194464
34,0,1,0,3,4,1209415.94898199,4525307.02775529
36,5,0,1,2,8,2135183.82648903,6100164.95246097
22,4,0,2,0,6,1338673.33482377,4363565.37775194
37,3,1,2,4,10,2392857.63204247,3304579.17309308
16,4,3,1,1,9,2087121.13312375,7091347.73828319
20,6,2,1,2,11,2132480.03474151,7994778.927241
11,1,1,0,4,6,1751564.97933944,4948735.08179322
36,4,1,0,2,7,1542605.74956057,9971306.61931637
30,5,1,1,5,12,2589336.05552999,7053498.42888095
37,4,0,0,4,8,1792047.50230539,7326410.80680201
35,3,0,1,7,11,1504016.82990937,6325933.60324264
34,2,2,1,3,8,1090848.43351139,7692519.60273465
13,2,1,2,1,6,1764705.81043153,5922977.58497593
14,3,2,0,6,11,2184184.89700739,4598629.37377368
12,5,2,2,4,13,2286229.84029019,7939710.80646177
19,5,2,2,1,10,2331608.72150402,6211613.05090861
14,5,0,0,2,7,1672585.10304803,3772311.84237491
27,4,1,2,3,10,2126133.3501426997,3881066.79862567
40,0,2,2,0,4,1452429.48750871,4867381.5742598
40,4,0,0,6,10,2005389.06909299,7962388.04322928
31,4,0,0,2,6,1604578.9513823,6139922.65244386
23,3,2,2,6,13,2376502.66666618,6831551.03478926
27,6,3,1,2,12,2231347.05614118,6352720.97076106
15,1,2,2,0,5,1325781.90054268,5971112.32757276
13,6,1,0,0,7,1157449.78235316,1261921.26299772
14,4,0,0,1,5,1156673.34408909,2634037.74826013
22,3,3,1,7,14,2214954.94285161,6679411.568621
32,4,0,1,3,8,1828748.48750061,94597.3161923895
31,6,2,2,7,17,2324918.89853412,5494364.97162505
12,1,3,0,5,9,2061178.71736876,4346111.37110296
34,0,0,1,4,5,1631497.20671861,3805548.48524311
30,5,0,0,6,11,2056227.01235227,6404353.16978256
12,3,2,0,1,6,1464284.11104898,5262118.06660815
34,1,1,1,3,6,1470056.0421234,7748658.47412565
10,1,3,0,4,8,1439929.72545139,1968782.26726565
17,0,3,1,7,11,1759251.22865188,4802318.19460213
19,6,0,1,6,13,1762569.80747522,12672892.6019041
11,6,3,1,6,16,3096542.54772758,8052769.58280252
32,5,1,2,4,12,2132034.03703675,9565974.33912268
33,0,1,0,3,4,1625554.22023017,4585857.36211272
23,0,2,2,3,7,1673378.04400752,7081960.53568232
15,5,2,0,1,8,1465246.97747652,6156873.74562056
22,2,1,0,3,6,1486856.52661471,5185737.61795424
26,0,1,1,0,2,1508256.60369114,1414306.77887707
22,1,3,1,2,7,1603356.65592342,3649524.30995568
12,1,1,0,5,7,1684866.10436436,3536587.62531118
12,0,0,2,6,8,1662547.10715148,5141662.21624357
40,0,1,2,5,8,1355298.56724278,5098998.26000447
15,3,2,2,7,14,2686531.86478101,7835720.54139842
37,5,3,2,2,12,1991596.53244518,5300813.41101015
37,0,1,1,3,5,1545936.90880588,5186848.12916717
31,5,0,2,4,11,2201284.39511311,4639228.61587531
20,5,0,2,7,14,2807144.89815929,9357241.10651922
26,4,2,2,0,8,2367521.59823623,8543181.34273681
12,5,2,2,0,9,1768128.57545919,4285342.19098912
27,0,0,2,7,9,1968903.63357572,4496737.36971839
23,2,2,2,1,7,1739398.24684265,1304532.86087948
33,1,1,2,7,11,2587465.30932944,2085663.65279389
17,2,1,2,0,5,1310225.73614866,5372177.2126222
35,6,2,2,7,17,1922443.62226209,7090746.76475205
35,6,0,0,4,10,1115378.52826435,6280498.36547804
21,1,2,1,5,9,2372786.53008934,5378727.85382729
18,5,1,1,4,11,2283470.03132408,6648001.04466335
24,2,2,1,6,11,2332886.61931679,7538650.93674328
19,5,3,1,4,13,2882004.6727134,5089309.3855016
21,4,1,2,6,13,2647348.43556243,6306068.52450518
40,3,2,0,0,5,1544502.59416117,4268044.1098022
26,1,3,1,5,10,2302055.07930787,5863043.2932234
26,3,3,2,1,9,1922935.10095996,5276434.16437896
30,1,2,1,3,7,2206334.81005856,4451574.77990455
17,0,2,1,3,6,1373222.71847923,6477597.62283657
23,3,0,1,5,9,1696830.33541265,7070774.62977851
18,4,1,1,0,6,1582753.36371382,5547140.02581893
10,4,3,1,1,9,1702360.08085066,6102789.41621317
40,5,3,2,7,17,2289708.95987112,8771527.65442979
34,1,2,2,7,12,2033321.02939329,8756956.10773479
15,2,0,1,0,3,1261826.91543173,4325253.40438908
37,3,0,1,7,11,1897742.80862119,6327993.87535038
10,4,0,0,7,11,2079270.10446908,4245884.68783972
32,2,1,1,6,10,1821689.04448713,6491258.42798083
12,3,0,2,6,11,1876072.03418574,3842801.0845959
17,2,1,1,7,11,2100628.23073785,7479401.69669087
29,0,3,1,7,11,1999133.66191314,6123989.48965267
33,2,2,0,6,10,2125564.79457883,6285165.73835311
27,6,1,1,7,15,1978616.697382,5672637.03847455
12,3,2,1,4,10,2004469.06489654,7624163.86547647
15,6,0,2,5,13,2227424.53501501,2118026.92360737
18,1,0,2,0,3,1621317.92380865,3169977.09464754
31,0,2,0,3,5,1474865.7867321002,4274800.42609161
13,5,0,0,3,8,1478599.92360245,6853123.28648404
36,3,0,0,1,4,1204362.08881515,3554468.22617835
36,1,3,0,6,10,2400211.96069942,5774314.44984445
20,1,0,0,5,6,1874060.60047037,4986985.67930504
27,4,3,2,2,11,1755244.51109884,5450872.63583843
21,0,3,1,1,5,1835339.66608257,5610709.45911769
37,0,2,0,2,4,1437707.00565987,1446868.57185175
18,3,1,0,5,9,1853968.50274133,5854065.592179799
34,3,2,1,1,7,1477141.35916609,3775844.59003182
39,3,3,1,0,7,2003425.44915373,3932768.1204717
11,2,1,1,7,11,2971257.06985571,6016427.25569668
21,5,0,2,0,7,1980093.60476035,3831337.87697519
29,6,2,0,4,12,2748869.40334655,6093997.58878933
40,1,2,2,5,10,1383281.67668473,5587839.73469174
23,5,1,2,7,15,1826556.5647329,5262359.47529578
27,3,2,0,0,5,1512819.93107018,4882925.98805756
13,1,2,2,1,6,1029644.34225464,6351738.56523482
24,6,1,1,2,10,2431289.83964363,6190503.74243875
23,0,0,2,2,4,1531411.8635654,3786904.51338695
29,1,3,2,5,11,1764761.5918401,7890217.31042977
14,5,1,2,2,10,1197994.89539617,5492060.82466687
18,5,2,1,5,13,2263660.3938322,5589536.93106837
36,2,3,1,0,6,1411606.53630785,5596824.6324738
39,5,0,1,4,10,1636982.36809712,8732199.97291825
20,6,3,0,0,9,1670315.03384225,7904290.75379664
24,5,2,0,1,8,1630925.45302431,5816261.67003604
10,0,3,0,0,3,1501628.99711949,2380089.10437659
24,0,3,1,5,9,2053007.014624,6806310.18311038
10,3,1,1,7,12,2084702.45001801,7209057.75240202
24,6,0,2,4,12,2114021.67738391,8798009.72407146
38,3,0,0,3,6,1523329.08334604,5452314.01629263
25,5,3,2,4,14,2375927.96840055,8395407.57944179
37,5,3,0,7,15,2649451.48024392,9589929.52102618
31,6,1,2,0,9,1562264.49382021,4395418.77620749
33,0,1,1,6,8,2357694.63127018,5281774.80389152
38,1,1,0,5,7,1165369.75482945,1637324.95856612
14,2,0,2,2,6,1637088.61815506,3840120.87268527
15,3,2,1,1,7,1605223.57716507,9957270.65502838
39,5,3,1,1,10,2346014.22777539,7393606.85428322
33,4,3,1,7,15,2746648.02536341,9496764.3662792
34,6,2,1,3,12,1951433.95104571,6038509.26253035
12,5,1,0,7,13,2352943.20774678,9522152.61298394
37,1,1,2,1,5,1610072.45668324,5637117.05075753
38,3,1,2,6,12,1738429.55147188,7135420.07314319
22,3,0,1,4,8,1762918.98418892,5845174.21800097
40,4,2,1,7,14,1827374.38626367,11909723.888914
11,2,1,0,3,6,813415.657408469,6676616.47122703
34,1,0,1,0,2,880153.017843987,3403291.6622419
27,3,0,1,5,9,1542611.4920417,7657565.49142324
10,5,0,2,7,14,2287185.88722188,6330126.77408549
17,4,0,1,4,9,2279180.98260138,6123705.28363748
21,5,1,1,3,10,2056077.50216727,6907908.83455229
32,2,1,0,0,3,1336086.60632041,5449721.49835823
21,5,3,1,0,9,1718566.23867911,4838288.49140294
32,4,1,0,0,5,1344307.47135023,2824729.81845296
13,0,2,2,0,4,1568181.95839893,7074936.10987055
23,1,3,0,1,5,1304841.56340812,4824746.20057581
27,5,1,2,3,11,2526464.79174993,6613303.01040131
36,6,1,1,3,11,1610508.5823461001,1083078.217349
21,0,3,0,1,4,1369716.9901507,2009929.06207173
18,1,2,0,5,8,1678031.63038271,4608170.53944536
36,6,3,0,7,16,2251842.15049364,8228073.82635738
32,5,3,0,5,13,2235969.72329558,6398075.239753201
24,6,2,0,3,11,2282925.86749915,6671732.38664001
30,3,0,0,3,6,1802735.01841618,3525719.9751615
24,4,3,1,2,10,1294598.30974219,8363780.86804046
17,1,0,2,6,9,1734284.30878021,4470186.05214747
40,1,2,1,1,5,1555930.88365254,4163456.91353632
34,6,1,0,6,13,2502865.65981874,8770504.75140903
30,4,0,2,4,10,1807161.69089128,4270436.69157329
35,4,0,1,3,8,1394926.43937778,5227328.78803036
25,1,0,0,2,3,842271.53600327,7370756.99271173
10,0,0,2,4,6,1656383.17458197,7245954.58481795
38,2,0,0,3,5,1975969.21456514,3654297.4325138
38,3,0,2,1,6,1311558.45946394,5330949.20660483
38,3,3,0,1,7,1568579.97619753,3881523.42863451
24,1,1,0,3,5,1378284.40373168,7861093.88076404
11,4,2,1,3,10,2012898.31024309,3812373.23938883
12,5,1,0,4,10,1990896.39403866,8158284.17172391
37,2,1,0,2,5,1306034.74637306,4044137.67258738
34,0,3,2,0,5,1588769.41472553,3751591.40699723
40,2,0,1,4,7,2109029.31143659,4439144.30564842
28,4,1,1,1,7,1887963.61108607,3504742.43498045
22,1,2,1,0,4,1561878.15194079,8202655.22509311
14,1,3,1,5,10,1908608.13648556,6578903.72690881
21,5,0,2,6,13,1941626.92463069,7135972.92041487
13,2,3,0,7,12,2132396.80109746,5892264.50616414
32,5,2,0,1,8,1627316.85090694,2680982.32264037
32,5,1,2,7,15,2485371.31200147,9172966.23749041
27,3,0,0,3,6,1616870.99186311,6041674.7428399
26,3,0,0,4,7,1925364.1430243999,3962212.86025372
33,5,0,2,1,8,1503178.00312104,6736122.64051155
39,0,0,0,7,7,1965538.77461179,4902181.36399174
10,4,1,2,1,8,2062224.78973983,4317173.83401356
16,6,1,1,6,14,1315338.93910822,4294325.1365136
23,2,1,0,0,3,1337418.7411148,4527243.62619685
16,3,0,0,6,9,1720151.99062738,6794590.30751093
34,3,2,0,5,10,2263657.42353793,2010668.90009525
24,1,1,0,5,7,1478185.77524573,5710602.12348499
38,3,2,1,0,6,1959795.20618392,7201049.252026201
30,2,0,1,3,6,1373956.53495938,3464684.38145807
19,3,2,1,3,9,1950916.31976339,8987990.74627201
35,3,0,0,6,9,1423488.36134674,2874609.30078262
16,2,3,1,2,8,1873670.27969752,2822824.36161365
11,5,1,1,1,8,2017283.30718295,5449051.78975293
20,4,2,0,3,9,1808366.19540147,7381185.57259588
36,3,3,0,5,11,2038962.68713004,5276757.90655048
37,4,0,0,5,9,2123350.88075376,4291837.0833135005
31,0,1,2,7,10,1913314.47012473,6095702.03854328
36,0,1,1,5,7,1803622.55348429,3917723.2138675004
15,0,1,2,7,10,2279761.6962051,6733977.82982189
27,4,0,1,1,6,1629032.59412145,7383620.32207622
11,3,2,0,3,8,1895155.91702058,1794510.33763561
19,0,2,2,1,5,1532147.1109709,5740593.67214382
13,3,2,1,4,10,1708789.17518105,9027902.03611872
21,6,3,1,3,13,2311954.84634266,9363579.27255193
25,1,1,2,3,7,1802106.49850977,6852255.79469174
12,3,2,2,4,11,2162753.28833649,7683185.26343694
36,4,3,2,6,15,2776612.38011994,8454039.1490206
36,3,0,0,1,4,1632776.87730194,5593827.42252642
16,1,0,1,0,2,1274458.2123216002,1996171.19240964
28,4,0,0,2,6,1611035.30981342,3679853.78860758
30,0,2,2,2,6,1691380.65576172,5117265.28712464
18,5,1,1,4,11,2026360.0628334999,3338428.93038707
40,0,1,2,1,4,1256515.50411559,2416808.17455915
25,1,1,1,0,3,907411.971303933,6042772.52813007
16,5,1,0,6,12,2082745.52819514,7698499.15418485
24,2,2,2,4,10,1759249.63410297,9270402.91510659
40,5,2,0,4,11,2341641.57764932,5521337.83453528
29,6,1,0,5,12,2206994.82283731,8929188.28472545
14,3,2,2,6,13,2531522.5360323,7356945.16804414
23,6,2,2,7,17,2947698.16694362,8943680.0273904
39,0,0,2,6,8,1579788.09108646,5581019.89009778
28,1,3,2,0,6,1524083.65336602,3929123.48485803
20,0,0,1,6,7,1872429.02243732,3121367.65219298
16,1,2,2,1,6,1159756.38895845,3450791.22679025
22,3,2,2,6,13,1851883.40670721,4754750.47030879
20,5,1,0,7,13,2488837.206383,5567181.62030999
25,1,3,2,0,6,1942845.83044888,6582530.03295062
15,2,2,1,1,6,1594711.29028427,4712978.493679
16,0,1,0,5,6,1899841.68208365,5048137.3634266
33,2,3,0,0,5,1263790.89717235,4180605.35545361
12,5,0,1,6,12,2027950.56131687,6630280.333372701
28,1,3,1,5,10,1758718.37048299,7120243.46466764
39,4,0,1,3,8,1388435.7853931999,4586879.37747208
39,5,3,1,2,11,1877625.6978858998,5516619.46336585
10,5,3,1,7,16,2699698.73968957,8093926.80087133
12,4,3,0,2,9,1729769.91381407,6670484.15923176
19,4,1,0,4,9,1499857.87161096,2993164.8076416003
23,0,0,0,6,6,1459424.88302288,5360941.13540492
20,1,1,2,4,8,1987390.06473837,7556762.15584116
18,3,1,2,0,6,1717606.45723858,7970060.16447191
15,5,3,0,2,10,1840375.92291321,9283648.90768357
40,5,0,1,7,13,2481549.86758897,6339285.64232806
31,5,1,0,5,11,2118966.40346915,9288633.23228119
13,4,3,2,6,15,2681644.34869446,9981481.22028365
10,5,2,0,0,7,1433329.67335443,5610040.31555676
10,3,0,1,5,9,1348794.24751262,4020520.98533584
36,2,0,2,0,4,1251174.07081403,4857242.82866855
16,2,3,2,3,10,1987019.27550211,3095803.50808011
29,1,3,2,6,12,2124128.97446722,6544696.954520999
36,0,0,2,2,4,1375361.49925397,2834662.80621213
20,4,1,1,3,9,1534953.46003187,8655871.26741393
28,2,3,1,4,10,1698310.56757018,7455853.54695376
38,4,0,2,4,10,1669994.25697788,9555325.45283167
38,0,3,2,2,7,2003803.10927736,7632364.45161289
28,5,0,2,5,12,2086969.82894147,4573731.80459531
13,4,3,2,1,10,2338208.95040471,8657873.32790571
32,5,1,2,0,8,1753084.73072245,3034068.46844515
22,6,2,2,7,17,2436975.90133077,11273701.9097108
32,4,1,1,0,6,1833177.38728462,6191084.00755277
38,0,2,0,4,6,1552358.52883345,5051782.42941179
11,1,0,1,5,7,1666580.32992146,2970512.93021814
12,5,3,1,4,13,2082998.28864948,9645288.87865382
28,0,1,0,4,5,1827639.2983906001,1521689.17751012
31,3,1,2,2,8,1691451.18107749,3534768.27709106
14,1,2,2,3,8,2416556.65049681,3619710.43788751
10,3,3,1,0,7,1349647.19895585,4849016.78515384
24,3,3,0,5,11,2788429.83180841,5895298.39005388
24,6,2,0,1,9,2008474.21176085,6518576.14235038
14,2,1,2,3,8,2216872.62304134,6163821.18589613
10,0,2,1,7,10,2029439.98517324,11105916.681454
26,0,3,1,3,7,1500513.35786587,1957541.11847031
40,5,3,1,5,14,2325820.46858094,8388687.005709
27,5,3,2,2,12,2361668.98145166,2512989.73028588
37,4,0,0,2,6,1769151.60065196,4897535.31604313
25,6,0,0,4,10,1996513.93710143,7632140.83290769
33,5,1,0,6,12,2047564.51624443,6356529.06829931
26,0,3,2,4,9,1779988.89838397,9275141.48710453
29,3,2,2,6,13,2761784.82992367,9436900.99674565
29,2,1,0,4,7,1727106.12073498,463942.250319652
19,4,1,0,3,8,1684766.64895573,5389041.79319343
26,1,0,0,5,6,1245174.24364583,5650474.27395089
35,4,0,0,2,6,1445680.43538952,5686100.81929859
20,2,1,1,7,11,2746664.53789742,6319185.48004195
18,2,2,2,1,7,1541676.00376393,6157069.91135633
15,2,2,1,6,11,1941564.23178726,5293039.56374735
35,3,3,1,5,12,2049408.64013976,10930863.641024198
15,5,0,2,7,14,2464095.22388742,8358184.30298746
38,0,2,1,2,5,1821674.50995178,4731334.81606697
24,0,1,0,7,8,2077162.14924163,6832219.8160572
10,4,0,1,3,8,1997706.96732724,5417900.87295047
11,6,3,0,5,14,1510803.01665986,5873119.16169456
11,3,0,1,2,6,1725889.02995352,4867789.79985543
31,2,1,0,2,5,1265463.58206649,1391124.69605603
10,6,2,0,6,14,1574484.2443577,4220339.53739699
40,3,3,2,4,12,2408921.24544417,5131998.84269816
21,2,1,0,2,5,1124065.91064345,4823228.22779215
16,0,1,1,7,9,1844703.88867842,5672607.77544592
33,3,0,2,1,6,1406012.80182942,6489750.92202743
27,6,1,2,1,10,1501695.65703134,7186330.59668818
38,3,3,2,6,14,2800995.54602278,4901050.58438355
39,5,0,1,0,6,1180822.60027003,4061562.07023228
15,6,2,0,6,14,2648608.2703341,6705675.70831637
36,4,0,0,5,9,2169182.10866093,3733712.33911428
38,5,1,2,1,9,1466020.42140497,7271029.53493095
11,0,1,1,4,6,1410638.20736803,4901435.62197752
30,0,2,0,0,2,1053201.66855227,4858062.5329987
16,1,3,2,1,7,1932523.44586598,2642840.19751559
40,2,0,2,7,11,2411933.28269454,6176813.17074071
19,3,0,2,5,10,2062369.58889357,5425726.76193361
30,2,3,2,5,12,1720767.31441014,4505964.4460759
37,0,3,1,4,8,1371340.79838639,5300230.51068577
30,6,1,0,4,11,2168928.37164003,5926998.78789095
16,5,1,2,7,15,2692244.6078017997,9885055.59648037
31,4,3,2,3,12,1863630.09643599,5085336.287545599
37,6,0,0,4,10,2749743.37242701,6282648.98661587
19,0,2,1,2,5,1470936.20080003,4824611.37490793
38,5,0,2,6,13,1742999.14749018,5850493.31538748
31,5,0,1,6,12,2068688.08056092,3665057.0919509004
30,1,3,1,1,6,1733384.4701062,4239117.63638645
39,3,3,0,0,6,1506028.76457293,4327493.44560231
21,0,1,0,1,2,772884.7170559721,5485996.42612609
16,6,3,0,7,16,2939516.87035562,9716801.13210726
15,3,3,2,7,15,1733461.29735176,7089643.77721865
28,1,2,1,5,9,1733178.2252981004,5987046.92034247
33,6,2,0,4,12,2393684.18683492,6142069.61395465
32,2,0,1,1,4,1172227.47981736,4461474.43450252
39,1,0,0,6,7,1912733.99116476,5239057.5855983
12,4,0,2,1,7,1620810.60781098,3877839.3312616
11,4,2,1,0,7,1990452.59521297,3558133.81604276
28,5,3,2,6,16,3001811.3686523,10294869.8986163
30,1,1,0,4,6,979051.522784287,6937007.21019868
32,3,2,1,4,10,2032877.07703472,3633173.54365544
18,1,3,2,1,7,1819334.22145759,4602304.875657599
35,4,3,2,6,15,2062302.93245518,5883128.59058936
12,5,2,1,2,10,1962973.29055834,4635875.09370823
40,1,0,1,7,9,1769591.00191588,5086067.24565699
18,4,0,2,2,8,1787119.7809861999,6162765.24643062
37,3,2,0,1,6,1302754.30724163,7057533.69552924
23,6,3,2,5,16,2919560.47075431,3890836.70744271
13,4,0,0,1,5,1346240.96002316,5030954.75898836
21,4,2,0,5,11,1644794.18931551,8576660.44016496
32,0,2,1,5,8,1364410.32972465,5980480.49757327
37,1,0,0,7,8,1737687.80861647,7715606.16803512
21,0,3,1,1,5,1305621.73705038,2820994.2496922
34,0,0,1,0,1,1399757.01852244,4886929.61908207
22,4,2,2,3,11,2397691.60439832,7118749.67409156
12,1,1,2,5,9,1776583.87258869,4516543.87714521
22,4,0,0,1,5,1717967.14630028,6071812.05177796
16,5,3,2,6,16,2796916.34923037,8715361.16670718
35,6,2,2,1,11,2001461.16364588,8027270.91598063
40,0,3,2,2,7,1667322.04470898,7061445.19979203
27,2,1,2,4,9,1455509.05186478,3266348.59212061
19,2,2,2,3,9,2330353.26441672,6618238.27519792
31,2,0,0,2,4,1657543.18760158,1593425.20859997
39,5,2,2,7,16,1949066.82894434,8144853.44669679
32,6,0,2,5,13,2625098.16849847,7675670.29053397
24,0,0,2,3,5,1509620.45175857,4789084.83277891
14,6,3,0,7,16,2886492.48415607,10304195.768188301
25,3,1,1,0,5,1595352.0053143,5521949.58311927
11,3,2,1,0,6,2214590.71646031,5114236.4708342
22,4,3,0,3,10,1799864.85971876,6852477.57579844
31,1,3,1,2,7,1737737.74659692,2323100.73212808
13,4,2,1,2,9,2188515.60111605,4090844.79325959
12,1,1,1,7,10,1809994.45178281,6740035.99613526
39,2,2,0,3,7,1677672.25396432,1515020.33758879
25,4,0,0,2,6,1225211.75320005,4306968.26681587
13,1,3,2,6,12,2442408.24194423,2504634.78613812
17,6,3,0,7,16,2871765.87158572,5288553.85649661
35,2,2,2,4,10,2081886.20498901,7740425.80325254
19,4,3,0,2,9,1333594.67619342,3727071.39814959
23,3,1,2,5,11,2820171.75047743,4605836.98140796
36,6,1,1,0,8,2096542.33800627,6516374.68887357
15,4,1,2,6,13,2283457.85606119,6581107.95802745
27,4,2,2,7,15,2177931.40875384,9242253.44055351
17,5,0,2,4,11,2663603.30760927,9351967.56097237
19,3,2,0,7,12,2240578.83708173,8244942.85035083
40,0,1,1,2,4,1261486.72002838,2535981.9762417004
23,3,3,2,4,12,2629379.85176267,8873802.04185413
40,3,2,0,5,10,1793193.78688711,8042272.83180113
14,0,0,0,5,5,1458044.11486991,4530312.45511036
31,3,1,2,7,13,2592894.33713625,6811871.62213364
35,2,3,2,4,11,1910388.58444108,4063543.36974649
17,1,2,2,7,12,2616987.04933303,3659781.89777017
35,1,3,1,6,11,2027810.70364968,3584855.23185172
25,1,2,2,4,9,2095695.27065229,3318712.00199909
25,6,3,2,3,14,2136193.00927649,5946191.834486
40,0,3,2,2,7,1539251.56385036,3005449.23303227
32,2,3,0,0,5,1444898.93899762,1810517.13807078
36,0,0,2,5,7,2196981.7259731004,5123608.22414191
36,0,0,1,3,4,1752505.77221611,1289968.66163178
10,3,1,0,0,4,1685492.99574044,3285336.86838581
11,2,3,2,5,12,2618292.75573641,6831391.28154928
38,4,1,1,2,8,1960938.52786326,6333321.58730893
19,4,0,0,3,7,2013738.37638752,3767904.62904238
14,6,0,1,5,12,2919003.16473225,6914223.13898499
37,3,1,2,2,8,1683752.70517898,5580300.05628327
24,1,3,0,4,8,1848642.46773546,7378829.55514909
27,1,2,0,3,6,1423689.19754461,4157517.11989298
14,6,0,2,5,13,2629411.20575115,8121363.70114325
33,3,3,1,4,11,1921313.02933175,8107531.12244333
16,3,3,2,6,14,2375922.83430265,7118428.61050134
21,3,1,0,7,11,1422168.4326195,9406921.13724744
23,5,3,2,2,12,2227865.19624075,4985308.22321282
12,5,3,2,2,12,2296829.96058538,6124074.4472456
29,0,0,1,5,6,1935484.48759746,2831404.00840511
14,1,1,2,7,11,2125103.8293742,4157699.61542122
39,0,1,2,4,7,1925154.02348595,4405612.83679688
22,0,0,1,2,3,1450275.9227035,4335565.04206496
31,4,0,1,5,10,1704889.6784264,3926710.84103553
36,5,0,0,0,5,1348305.6920558999,3083312.33591659
37,6,3,2,5,16,2259142.26635549,10522065.798304599
22,0,0,0,0,0,767485.1719555979,2340345.42068154
25,2,1,2,7,12,2342207.81495952,7581731.283532499
30,5,3,1,4,13,2260528.10063936,4042615.79592751
26,3,1,1,6,11,2176996.15995168,5537788.12670879
26,5,1,2,7,15,1752875.7614817002,9627884.56873301
26,4,2,0,2,8,1712946.72906766,10072161.570112899
17,1,0,1,4,6,2093182.0809526,2176568.87141277
34,6,0,1,1,8,1813361.75215859,2704584.01742786
13,1,1,0,7,9,1790512.65397442,5313634.9409855
20,6,3,2,7,18,2690370.59156393,8046933.04165782
38,1,1,0,5,7,1931930.07366598,3712592.60936666
14,3,3,1,1,8,1464070.85981761,7610647.46033281
32,4,1,1,6,12,1819852.68964688,7923854.82598951
19,3,2,0,4,9,2286847.85171273,3067910.46112271
24,0,1,2,0,3,1146486.16329359,3662800.24713642
20,1,2,2,2,7,1751608.82034934,4167599.06248056
37,6,2,2,0,10,1820138.87450254,5251599.39676397
22,1,0,0,7,8,2050135.75694677,5994668.91130508
36,1,3,1,0,5,1428398.4563183,1540690.37159934
11,0,1,0,6,7,1430127.80263489,5136991.18118976
15,2,1,2,5,10,1912940.72555808,6702448.0641585
17,5,1,1,6,13,2153535.05249768,4380054.0456938
38,4,3,2,6,15,2142001.94606122,4190718.97841735
22,4,3,1,6,14,2801159.82528712,6828626.13196295
30,6,3,1,4,14,1838362.16025376,7424008.78972889
18,5,1,0,3,9,1793548.56106093,4799224.05885722
13,4,0,1,0,5,1339465.25775122,6557771.38718705
33,3,1,1,2,7,2324912.24805828,3109831.81302154
24,5,2,0,4,11,1882065.21443407,5522808.60394166
21,0,0,0,7,7,1949293.19358532,4893357.10989656
10,6,3,0,6,15,1153511.85177427,7423940.20319176
37,1,3,0,0,4,1005031.98729848,6139672.6551904995
21,6,0,1,0,7,1876179.91462216,3405733.00961889
28,4,3,2,1,10,2351165.05146096,4184336.86336118
36,5,2,1,6,14,1922493.3625341,8230594.61357906
37,1,3,1,5,10,1576825.97315233,4973847.59520967
33,0,0,1,0,1,1073844.90165454,4180098.43701652
15,6,0,1,5,12,2761986.30690865,8085835.26401894
29,2,1,0,0,3,1482097.54907811,3716366.85980465
40,5,2,1,7,15,2896588.57751386,8849807.45590932
34,5,2,1,0,8,1919473.35333301,2898492.52762082
30,1,3,0,3,7,1740387.68742113,5786985.27164785
37,6,1,1,4,12,2054047.90212402,8048295.59732205
26,3,3,2,2,10,1574096.98034959,6573823.19873801
37,2,0,0,7,9,1423988.96867413,4596236.24212819
31,4,3,1,3,11,2329244.91126829,2711622.37321103
36,1,3,1,0,5,1650967.62026573,4918516.95854827
38,0,0,1,5,6,2138320.35252839,3347489.56796602
39,2,1,2,0,5,785100.648911269,5752093.94084921
16,1,1,2,5,9,1964135.21865252,8684971.81956857
28,3,1,2,7,13,3249249.67718379,10298032.1001755
24,1,1,2,0,4,1256154.36731854,4795346.88829887
25,6,0,2,0,8,1737394.03912656,7129165.26184008
19,1,3,1,7,12,1874504.92664921,5405021.11003593
36,3,0,2,2,7,2036650.30089329,8433399.41802599
30,0,2,1,0,3,1838900.62808234,4425141.66864983
26,0,0,1,4,5,1101360.08099015,3100352.05994711
27,4,1,1,7,13,2225864.01490296,4552303.94645357
26,5,3,2,7,17,2721376.03005204,8431670.90607479
29,5,1,2,2,10,1601559.69900552,5338361.1317917
17,2,0,1,1,4,1750360.82674272,5867946.77581399
13,6,1,0,4,11,2624498.237472,3181898.80259771
34,0,1,2,7,10,1558990.00013599,9253854.35157747
14,4,0,2,1,7,1848188.73587114,5188974.4102511
25,4,3,0,6,13,2718406.59914153,8249605.8646859005
34,2,0,0,0,2,1080996.16429922,3079241.20294236
33,1,1,2,6,10,2203979.26345669,5455269.94067103
18,4,0,1,0,5,1303185.27018625,5967322.77094883
20,4,1,0,3,8,1880469.98605354,4276820.79130042
22,1,2,1,6,10,2328474.94996022,6033523.4271114
15,5,1,0,3,9,1305349.41593882,8134953.67354343
10,2,1,1,2,6,1318905.41035974,5183052.39925408
10,6,3,0,0,9,1661533.38326547,2667899.92579362
36,1,3,2,7,13,2227559.07045716,12346609.949867401
35,5,0,2,2,9,2347408.71669147,6480930.58344136
15,2,3,2,3,10,2133797.48078017,5007087.23757958
17,0,2,0,3,5,1550680.61481132,1574158.64279172
25,2,3,0,3,8,1847082.87860035,6628529.628917701
28,6,2,1,4,13,1959717.45532649,6784675.56231696
22,6,1,2,5,14,2274919.74096778,5880819.12602229
27,1,1,2,5,9,1945619.15512802,4489214.78755736
12,2,1,0,0,3,1180326.65066093,5681573.12139151
34,2,2,0,6,10,1721271.32663161,7382277.30666812
29,5,0,0,1,6,1955726.55426392,3750274.86533332
38,5,2,2,0,9,2030795.17530852,4865629.17716826
27,4,1,0,0,5,1617620.23752873,4908664.01328356
16,5,0,1,1,7,1286423.79131545,4711925.18506903
11,2,3,2,6,13,2794187.88498371,5988004.61979808
12,1,3,0,2,6,1596734.94056857,4910137.21297141
27,3,3,2,3,11,2044992.65291952,7041225.72965033
24,4,0,2,7,13,2589234.79512214,6354383.19134306
27,1,1,2,7,11,2247390.28021437,7492328.06792475
22,5,1,0,0,6,1699156.8369779,4944734.11620151
34,5,3,0,7,15,1562723.15734731,8945343.26676961
19,1,3,1,5,10,2745747.49662153,5190851.83323854
17,2,1,1,7,11,2614444.47757192,7069860.78173663
31,4,3,1,5,13,2091670.89107405,5845636.44082281
26,6,1,0,7,14,1876030.32648696,9855542.10484375
23,3,2,0,6,11,2097893.47232785,5678101.5010587005
33,0,0,2,1,3,944814.4020967941,4126932.67350521
36,0,3,2,7,12,2426604.45926746,5745760.20979922
22,0,2,2,3,7,1757394.573209,3089433.18228599
25,6,1,2,6,15,2676621.89468647,11525263.444146
36,3,1,2,4,10,2587898.2402056,6059692.30480668
31,3,1,2,1,7,1942290.09717,51201.800633444196
24,2,3,2,2,9,1583890.34042798,5522424.36612806
13,0,0,1,7,8,1603004.31460148,8727489.95936092
16,5,3,0,2,10,1806874.66618064,6227386.5692312
13,3,2,1,4,10,2058293.74195197,9007444.47915931
17,6,1,1,0,8,1743094.10352312,6708017.77097177
17,5,1,1,6,13,2701477.95732266,4933855.69742475
30,5,1,2,3,11,2562583.8377325,8907384.0796735
21,0,1,2,5,8,2239305.12190423,3745324.96541671
32,1,0,2,4,7,1550627.49401515,3739266.94543492
12,4,0,2,5,11,2565469.14036219,6679306.73146139
35,5,1,0,3,9,1944510.45688834,9047562.44031757
12,5,3,1,7,16,3548723.42256961,7862267.96171381
17,2,0,0,5,7,1468794.77494045,7400293.15018497
35,2,2,0,7,11,2130959.24395361,8497878.68122112
38,3,0,2,1,6,1634873.15066279,5704455.05963617
21,5,2,1,3,11,1858733.25364342,4559467.49693127
37,4,2,2,3,11,2761390.65513425,4354929.41950192
32,4,3,1,0,8,1926342.69384766,4747190.60572365
37,4,0,0,1,5,1571396.51283935,5038150.75107511
10,5,0,0,0,5,1258794.70161747,6128415.088600401
17,3,2,1,6,12,2876718.35752081,5032395.84253601
13,5,3,1,0,9,2438620.54340011,2937258.48707417
38,5,1,0,7,13,2665901.74516215,9923199.11216505
32,4,0,2,1,7,1700588.38070299,6986629.09347783
26,6,3,0,5,14,3033044.07971489,8428983.75796074
27,5,0,0,0,5,1554518.30498079,7905617.79559949
28,6,2,1,3,12,2394388.80177775,12360736.1123281
27,2,0,0,3,5,1651874.76494602,2972991.18875301
39,2,3,1,2,8,2235693.64737207,6389733.94435486
17,3,3,1,1,8,1739650.02246036,7681935.75574649
15,2,0,0,0,2,1474822.04230899,370696.180324745
11,1,1,1,6,9,2041106.05182901,6835386.45688713
40,6,0,0,7,13,2008652.11333278,10274735.840933999
29,2,0,0,7,9,2275096.19068903,5511146.64614611
11,0,1,1,6,8,1346203.00577284,5522230.3873433
32,5,1,0,0,6,1680425.91313076,5222404.99832775
27,6,2,1,3,12,2027784.4031393998,10294223.6403612
26,5,2,2,4,13,2319876.84239159,5333068.25803749
19,1,0,1,6,8,2054050.85529914,5789242.88865789
20,6,0,0,6,12,3092265.55725285,7818673.24178187
12,4,1,2,3,10,2754602.8255575,3082361.36152974
33,0,3,1,6,10,1899625.33855936,5742739.67330522
17,1,3,0,4,8,820202.2449383821,5566316.26103364
39,6,2,2,0,10,2037827.20535841,3202601.77213601
25,2,3,2,7,14,2669449.60419529,5955011.74646311
10,4,3,0,3,10,2316049.34594351,7379002.08171224
16,6,1,0,0,7,2286756.28375727,5178702.04713332
29,4,2,1,7,14,2457911.36138596,7637038.60013745
26,4,0,2,4,10,2167999.8023338,6927284.70697759
34,4,1,1,3,9,1551559.90099187,4772128.05594818
28,0,2,2,6,10,2152396.28789547,5509283.25858849
21,6,1,2,6,15,3022735.37442493,5819687.07483227
32,0,2,1,4,7,1518419.08989133,3941987.71204879
21,3,3,1,0,7,1733238.46689142,5786257.9889339
23,0,1,2,3,6,1898888.45754167,4650445.83617958
21,5,3,1,4,13,2564570.72342549,8819605.44274856
20,1,1,0,0,2,1078927.80454412,3342850.6187932002
36,2,3,0,1,6,1034505.90227042,5815400.26791776
17,3,2,0,5,10,2391200.65451239,9736313.27956538
12,1,3,1,6,11,2421007.80569153,7522286.0923291
32,3,0,1,3,7,1918929.75353508,4521941.86949663
38,2,0,1,0,3,1609480.36173502,3541654.07250069
21,6,3,1,4,14,2600079.61865499,5845659.71921747
36,0,3,0,3,6,1153773.5091714,5578888.15152207
32,6,0,2,1,9,2009978.11198877,3570260.61782876
15,4,0,1,6,11,1908550.79766182,5206853.36339373
40,5,1,0,0,6,1948266.3813131,2753635.49327489
10,2,1,0,2,5,1329191.84509443,4261198.63744936
11,2,1,1,6,10,2364105.78747382,6782054.13604158
32,5,0,2,3,10,2154211.46668158,5678727.65764028
20,1,0,2,1,4,1365010.38570057,2038247.57470933
40,1,3,0,7,11,2268572.79984919,8063550.89446449
36,2,3,0,2,7,1601916.01083225,4738168.62142953
33,2,1,0,5,8,1317933.13557353,5082938.53195922
30,3,3,2,2,10,1839678.16936653,5786157.08298026
33,2,3,0,3,8,2113122.47734444,5036113.17314573
30,6,1,2,1,10,1824054.90031822,7835811.7614782
11,2,3,1,7,13,2240578.34402817,9322882.90184202
28,0,3,0,7,10,1966086.51091803,5880052.04313762
31,1,3,2,4,10,1997978.87557474,9684374.41413761
32,4,3,1,7,15,2632756.57393392,8129133.38385059
10,0,2,2,1,5,1678773.44376082,8688741.57980031
27,6,2,0,2,10,1756514.4607213002,7702360.18233358
34,0,0,2,4,6,1796398.86326771,6016409.98866179
15,0,3,1,3,7,1447127.17494461,5129079.73960678
34,1,0,1,7,9,1943827.48825817,4706902.57651769
27,0,3,1,5,9,1487211.45111717,3777829.26770246
33,2,3,0,4,9,2224249.21058859,7207115.89196781
34,0,1,2,6,9,1767633.9383887001,8049400.22310263
17,1,2,0,5,8,1577845.69073218,5666600.63469064
38,1,0,2,1,4,1418569.21859818,7217236.74113431
13,2,0,2,1,5,1911544.62991697,4544706.86778303
29,5,1,1,7,14,2248433.36240659,8849844.17763113
16,1,2,0,6,9,1299197.43849062,1829522.95690668
10,6,1,2,7,16,2681284.92176227,7881134.63611056
25,2,2,2,3,9,1918105.87422587,4702511.59831954
35,6,2,0,6,14,2975075.40017537,7732401.45004674
23,1,1,1,1,4,947709.646338166,5164078.10159273
31,5,1,1,0,7,1365434.70203718,4646671.84525362
11,6,0,0,7,13,2077572.62545186,3896308.21277472
11,3,2,0,4,9,1974580.66624107,5043405.99263114
35,5,0,1,1,7,1726444.57829802,5045470.85182866
12,1,0,1,6,8,1775135.13388212,5052394.78171974
33,3,3,1,5,12,2633071.98414981,9058998.75570567
38,1,0,2,0,3,939420.494649844,3953579.4093432
20,4,2,2,6,14,2579218.83513027,4032750.46002635
29,2,2,2,1,7,1666685.00054372,6947600.86818277
20,1,2,2,7,12,2046424.55436004,4665545.05250781
10,3,0,2,7,12,2585249.76606225,8261588.4484075
27,5,2,2,0,9,2486056.88104786,3989104.56775772
16,0,3,0,7,10,1932590.65142486,9001216.40643577
18,4,0,0,4,8,1829905.33850209,5013184.50132484
24,3,0,2,2,7,1770426.37932178,6261705.37201659
17,0,1,1,4,6,1865367.65385837,6310483.25204188
30,1,3,0,2,6,2056045.44343438,4025606.10376756
23,3,3,1,3,10,1636024.10812557,5755258.26998739
40,1,3,0,6,10,2095538.10965054,4884349.3115984
10,1,0,0,1,2,1393308.62287659,4919800.97732335
17,3,1,0,3,7,1710465.74616038,5373746.020774401
20,2,0,2,2,6,1458525.46164615,5564767.98259671
39,3,2,2,6,13,2147861.63330376,5684914.16082518
19,6,0,1,6,13,2063925.99782025,11679399.7786093
19,0,3,2,3,8,1909214.43548138,3884198.3862727997
40,3,2,0,1,6,1473123.81369425,5532331.04724213
38,6,3,1,7,17,2156763.60434032,6563482.87217472
10,4,0,1,1,6,1668276.69222585,9177516.05110696
16,1,2,0,5,8,1434299.66487711,8183909.64762842
31,4,0,0,3,7,1774472.24274376,2988055.83345843
26,5,1,0,4,10,2166867.39858192,5083315.49321024
11,1,3,1,3,8,2002717.35501879,6209144.94550291
39,5,1,1,6,13,1557962.07372725,9641937.24109854
38,2,2,0,2,6,1492347.28051397,3745501.880279
26,2,1,0,4,7,1396576.81339646,3797939.05998799
20,1,0,2,3,6,1464478.72714855,4617340.125703599
24,6,0,2,4,12,2211152.76200763,5140538.357757701
22,4,3,2,1,10,1530850.92362302,4144284.08843715
32,4,2,2,0,8,1764444.61888054,4494389.54576908
34,4,0,0,7,11,2357226.92155811,4444933.09509343
18,5,2,0,7,14,2711932.93426345,7933745.96860552
39,6,1,1,5,13,2998070.27248917,10219053.8751312
15,4,1,1,5,11,2436430.61198241,4230944.72951921
21,4,1,1,4,10,2205902.83629766,6737438.49978331
11,1,3,2,6,12,1480586.87317916,4963950.0803857
19,3,2,0,0,5,1402555.30069418,924018.82218189
38,2,3,0,7,12,2156495.27605699,5616088.31035614
31,4,3,2,6,15,2703890.75289469,6944716.62591541
39,6,2,2,0,10,1770550.12339906,5454251.12717533
32,4,1,2,6,13,1996531.96389585,7104435.12782249
31,4,2,2,5,13,2409895.12369043,6142563.74612655
28,6,0,0,1,7,1557198.22782845,6148072.9532085
23,1,3,2,4,10,2126838.50409933,7425474.29107522
10,2,1,1,4,8,1435851.88978642,3129817.61332443
15,3,3,0,2,8,1636157.69367636,7506161.83503294
30,4,3,2,7,16,2566599.90382479,8874025.74802518
34,3,3,1,7,14,2550086.77714409,3286869.64722737
32,1,0,2,4,7,1729260.55943149,2702561.57124938
23,6,1,1,7,15,3470309.02538348,9319371.56118532
12,3,2,2,7,14,1847554.56909657,12024889.836344698
10,3,1,2,0,6,1917699.77128137,5111470.06525781
23,5,0,1,0,6,1413375.57248877,7699667.27757041
28,5,0,2,0,7,1958062.66267033,4928598.47673793
16,1,0,1,6,8,2260379.87350804,532831.167174096
28,5,0,0,6,11,2244983.08535381,8902134.95331201
39,3,3,1,0,7,1096781.31160513,4986573.40559163
19,3,2,0,0,5,1250489.31036428,4902945.9868617
12,3,3,0,5,11,2372724.18625908,2446666.25904508
15,6,3,1,7,17,3025027.25795338,7844108.04583274
21,1,1,1,7,10,2418269.38792074,8320121.09800548
20,5,2,0,2,9,899855.90431291,8714168.59107063
29,2,3,0,4,9,2322489.49682277,5593690.26460171
15,5,0,0,3,8,1366049.53918093,3659002.89770021
23,1,1,2,5,9,1951864.54694932,5543380.98410631
16,3,1,2,2,8,2194038.91077665,5435325.49455244
26,3,0,2,2,7,1292633.81043225,4658099.92299556
15,5,3,1,3,12,1431889.83280128,4484658.66673031
32,1,0,0,0,1,1235800.73758135,2021353.15343591
25,4,1,0,0,5,1227676.63741038,6272728.17865422
17,6,3,0,5,14,1978900.82062273,10071578.202411
30,4,0,1,7,12,2249514.09012263,10521433.6660956
18,5,0,0,4,9,1806387.41266709,3483396.28045534
37,0,0,0,2,2,1416262.34362847,1697174.72031517
28,2,1,1,6,10,1623111.44939797,6450127.59946134
32,4,1,0,7,12,2570286.06326594,8467640.99211077
40,3,2,2,4,11,2463832.44233525,6920459.54945498
14,5,3,1,2,11,2350078.84025491,6542887.89751794
40,6,3,0,0,9,1663411.20444862,7482612.75210334
39,2,2,2,6,12,1937157.29275399,6172403.35820677
16,5,0,0,4,9,1733060.56458481,4175415.28809806
32,1,1,2,6,10,1740859.81950874,3327782.11333073
31,1,0,0,1,2,1266908.33821665,4660397.40926045
13,1,2,1,3,7,1571502.69552485,7047270.35720607
26,6,3,2,3,14,2728555.86244119,7800513.26678099
23,6,2,0,6,14,2445774.29572839,5399871.75766584
28,4,0,1,6,11,2519256.5895558996,5334461.61156488
37,1,1,1,6,9,2139011.29422021,5887804.4046155
33,4,3,0,2,9,2310407.92379094,4105071.46099736
31,6,2,0,7,15,2487773.44304005,10307959.69238
14,2,2,0,1,5,1494601.32487598,7619754.50162516
19,1,2,0,7,10,2046037.50231074,4929084.67357728
39,2,3,2,3,10,1707221.23080702,6651626.74680226
23,5,0,0,1,6,1906638.29629608,5998601.14647843
38,6,1,2,4,13,2460871.07360676,3636967.6421011
34,5,2,1,1,9,1920086.20163505,4056330.36664785
24,6,2,1,1,10,1699828.05381597,7816591.76355372
34,4,3,2,3,12,2305446.81087434,9956794.10949132
10,5,2,0,6,13,2237020.20395428,11316234.239419501
14,5,2,2,4,13,1702188.7682063,6315539.43699974
12,1,0,0,5,6,1970063.74211425,4788468.78981028
19,6,2,1,1,10,1454618.17210648,9687477.30605741
17,3,1,1,0,5,1615936.68260132,3450942.90364048
21,5,1,1,1,8,2060630.80819118,3901746.05663295
26,1,2,1,7,11,2589492.88572269,5217678.94719751
10,6,2,1,1,10,2707236.21237573,4400056.38936192
37,6,1,2,5,14,2358054.04030434,8263220.95457225
31,5,0,2,2,9,1425197.41436445,4248611.99881939
32,1,1,0,1,3,1787765.43513052,4433276.27357077
40,2,1,2,4,9,1644956.02452714,7701548.97165746
20,2,1,1,7,11,2060406.78873317,6724302.96855712
24,0,0,2,7,9,2067718.99651781,5880604.01036588
40,2,0,0,0,2,1150127.60523403,3170094.18174354
21,0,3,1,5,9,2124542.84079759,2295292.13819639
28,0,2,2,4,8,1546411.65479574,4778454.90507846
17,2,2,0,5,9,2164190.3057363997,5434052.31060614
17,1,1,0,6,8,1898727.37628838,6019981.742415099
33,5,0,0,2,7,1190796.73683011,5624246.85078588
36,4,3,1,2,10,1778223.62559065,8304953.26294597
10,2,2,0,0,4,1259502.03824319,3953975.30934452
23,6,2,1,3,12,2698732.72358483,9080463.74893514
10,0,3,0,3,6,1736481.2126942002,1408840.89776038
32,4,1,1,4,10,2772232.54970728,5342883.63043254
32,1,0,0,7,8,1669696.81703119,8281418.21234698
24,1,0,2,7,10,2014982.75026365,4744817.65006013
39,2,3,0,7,12,2083221.90312896,6898113.32987807
38,2,3,2,7,14,3216317.04260267,7422053.61452814
23,3,1,0,1,5,1759824.44652402,6971326.0395119
23,3,3,2,1,9,1328464.5510517,3965052.34613803
38,4,3,0,7,14,2196907.56380541,10607525.055215402
34,5,0,0,0,5,1386152.56501897,6231707.25047893
32,6,3,1,1,11,1614882.82611041,5406314.32432933
30,5,3,1,6,15,2616593.96674357,6315044.88431797
20,6,3,0,1,10,1976721.18335455,5567900.20941579
20,4,0,1,2,7,1991793.8878621997,3057688.6161392
15,1,3,0,6,10,1887368.32705044,4867949.49171895
11,0,1,2,0,3,1063174.71364148,4678915.20083309
26,6,2,1,0,9,1864261.73144474,4837568.37105685
23,4,2,1,1,8,1819481.84552124,5636792.31669932
36,5,0,0,6,11,2242034.94452876,6982377.13208425
36,5,2,1,7,15,2795842.62608478,5863477.90877557
17,3,1,0,4,8,1285932.7241633998,6829669.57740833
33,4,3,0,1,8,1720825.96544365,7152759.61587526
33,4,0,0,6,10,2012264.17966869,7040228.64610217
13,0,0,0,5,5,1543775.08456536,3897653.4645007006
24,0,0,1,4,5,1156232.06437349,2258934.44384196
28,0,3,0,2,5,1720838.87426989,5488460.57848836
38,2,3,0,5,10,1707924.79932258,6334200.64090825
20,0,3,2,0,5,1095054.17287026,5381762.91280385
12,1,3,1,6,11,2160746.38692974,4726203.04981599
30,0,2,0,5,7,1809428.19196688,1514358.44711155
32,1,2,2,3,8,1963013.65950168,4180704.89887803
17,2,1,1,4,8,1368784.8676408,5121774.85308533
15,3,3,1,2,9,1890055.23054012,3828704.3325248
36,5,1,0,6,12,1919780.88754036,1954367.58135907
31,0,2,1,6,9,1899274.36150979,4843127.82933899
38,6,3,0,7,16,2131307.32140109,8499039.85023934
26,4,1,2,1,8,1692811.93743542,9014824.47630838
33,4,0,0,3,7,2186309.47301225,3949612.04776972
39,0,1,1,2,4,1312839.48871836,4408507.25336233
23,1,2,2,7,12,1887991.24140493,7857773.8951892
27,6,2,0,6,14,2189072.86063808,5702322.81416665
15,0,2,0,0,2,1067102.36721012,3271203.64728911
34,5,3,1,2,11,1445484.63996302,8206745.15471149
18,5,1,2,3,11,2510404.79144367,2955609.7503539
37,6,2,0,4,12,2431244.47659216,8561464.30206997
21,5,0,2,1,8,1874189.68683036,4435165.52018267
16,6,1,2,5,14,2676145.84642884,4438643.95480377
11,4,3,0,6,13,1662396.5395101001,6637526.21138052
12,3,1,2,4,10,1611891.35603206,5146355.85682332
24,4,1,2,0,7,2045437.0974316,6801763.0466713
15,1,3,2,6,12,2502323.09873371,6818293.43507496
26,5,0,2,2,9,1750753.15838786,4441505.84373135
34,1,1,0,2,4,1169404.40654899,6992371.5561435
37,3,1,1,4,9,1544571.97404769,3803335.35762868
26,3,3,2,7,15,2729751.85867371,5407450.65730755
33,0,0,1,5,6,1800543.62959327,5178680.92761544
32,0,2,2,4,8,2025087.26947024,5416369.04786959
17,2,1,0,4,7,1504073.80069917,5703820.34854524
26,4,1,2,1,8,1754183.07831273,6582874.35607341
37,2,1,2,7,12,2118770.05655664,5048720.30321723
30,1,0,0,3,4,1461356.24173349,4309331.08211623
37,3,0,0,1,4,1556695.37892637,3520631.21912764
17,1,2,1,2,6,1353937.45653054,2440423.73897197
35,3,2,1,3,9,1483795.86965397,4975610.31381119
19,2,0,0,2,4,1551223.1918684999,6537831.62733569
30,3,2,2,1,8,1448052.15275031,6656771.90245619
13,3,2,1,1,7,1510367.87898058,7361898.86264446
35,1,2,0,1,4,1247391.09905945,3197183.86304286
28,2,2,0,0,4,1336723.81003221,5593947.65895303
17,4,2,2,6,14,2269806.18459588,5396415.68211464
10,6,0,1,2,9,2023692.41536093,6667165.11651894
23,1,2,2,0,5,1583296.8536004,2736426.99306353
10,2,3,1,5,11,1931356.42933074,7229370.17759103
24,4,0,0,4,8,1775881.62843533,6246967.40521388
32,1,1,1,4,7,1824902.11383121,4514525.20482933
33,0,0,0,5,5,1775971.36234032,5750631.18393828
38,6,1,0,7,14,2799703.59490253,6034646.93193492
27,3,3,2,7,15,2325015.46551343,6438492.08431561
32,4,2,1,6,13,1876508.80694811,8754410.1935664
35,6,0,2,6,14,2230394.72142949,6073648.81117794
13,3,3,2,3,11,1702456.61359155,5837283.04771577
16,2,3,1,1,7,2139279.29754668,3944107.81820218
32,2,2,0,7,11,2777337.89505735,8529362.83149212
34,0,3,2,6,11,1881500.63083583,7018718.49391765
28,3,0,0,7,10,1851641.07492841,4351395.99727978
11,2,3,1,2,8,1765423.79819034,4782232.162550701
30,6,0,1,1,8,2245708.52655767,5946005.15229163
13,6,3,1,5,15,2225999.11387626,8329919.51076569
38,0,3,2,1,6,1492348.61567068,4005006.55690975
20,3,2,0,3,8,2268396.37879877,4269829.54517667
23,1,1,1,5,8,1775522.44542134,6464800.28308417
25,1,2,1,4,8,1792300.54202747,5778056.55899518
21,3,2,1,4,10,2174925.43411823,4310339.86974993
40,3,0,0,2,5,1408358.46253882,4191261.86208509
28,4,3,2,2,11,1937009.81876211,4365404.45983659
36,3,1,0,2,6,1196577.22111785,2909585.65785284
17,2,2,0,3,7,1654987.52432479,7500878.01256103
10,0,0,0,6,6,1274589.51592097,5062744.73579011
20,6,1,2,2,11,1767985.27424643,7357151.38241019
29,5,3,2,5,15,2524284.32691292,10740471.087387599
37,1,1,1,0,3,1422835.7224508002,5437291.14288761
19,2,0,0,0,2,1316121.2459331998,4908351.21467601
25,4,3,0,4,11,2202460.90561041,8736997.00562282
26,3,1,2,1,7,1419356.49376449,2762625.89116314
32,0,3,2,5,10,1831009.18727231,8035064.12657157
22,6,3,0,7,16,3054888.77786198,14546223.9782302
26,6,1,0,5,12,2695812.81595653,7186268.8971552
40,2,1,0,1,4,1548574.38337803,4210208.71127371
14,6,2,2,5,15,2429640.21686229,12466837.726444501
31,0,3,2,4,9,2578706.77327097,5005558.54774511
32,0,1,0,2,3,1099382.30994702,1917565.46403268
26,3,2,0,0,5,1448619.98455781,4005111.92535232
28,6,2,0,0,8,1620631.03587751,4787988.68395526
23,0,2,1,5,8,1787551.69308787,865789.831645075
21,0,2,0,0,2,1747721.57256415,4971489.79684922
18,6,3,0,6,15,2716610.63332812,9863705.66400513
26,1,3,0,6,10,1675895.20019779,7077092.10844134
34,4,3,0,7,14,2234038.0143785,5395734.79272518
27,0,3,2,7,12,2394608.39103431,10195556.335605498
29,3,0,2,0,5,1363250.75119088,5030174.13630507
26,4,2,0,0,6,1387017.08513365,4481106.13598674
29,4,0,2,0,6,1450444.2563167,4450026.66830122
39,3,2,2,1,8,1587487.99590178,6565511.11324482
39,4,3,0,3,10,2052821.80448111,7671723.62034638
31,1,0,1,5,7,1676997.0304728998,5698119.13393814
37,2,3,0,4,9,2409208.61193913,4192056.86753893
20,3,3,0,0,6,1765252.17664602,3435816.81259169
30,0,0,2,2,4,1447258.0535483,6652525.65964853
38,0,2,1,2,5,1083546.5464921999,4569658.03624083
12,6,3,1,2,12,2080715.68253051,9214890.12623757
31,3,1,1,5,10,1864680.09193889,9637167.49193618
11,0,1,1,5,7,1447055.92439548,2474513.43140716
40,5,1,1,3,10,2280837.30908342,6894243.00190089
16,5,3,2,0,10,1422167.26159198,5819629.16596198
15,4,2,0,5,11,1816256.89330728,2350648.62158574
26,2,2,1,5,10,2211412.04642725,6655359.47542548
10,1,3,1,6,11,1986437.26377867,5524388.71765984
27,4,0,1,0,5,1712325.85869747,6770660.76534919
34,2,2,1,2,7,1250553.43190034,7458420.4825422
39,6,3,2,7,18,2431128.26907712,3314842.79250891
13,6,1,1,4,12,2200052.7927667005,7318297.54699707
18,5,1,2,4,12,2547077.34311178,6476321.973864701
33,6,1,2,1,10,1999827.62399395,8393431.70164947
13,5,2,0,0,7,1398245.2494816002,6836464.92800847
32,4,3,2,5,14,1601903.36405278,8342074.32003568
29,2,0,2,1,5,1482542.9716001998,6371639.85746633
22,0,1,2,6,9,1547691.5620829,4348403.96941624
35,0,1,1,4,6,2023512.58609697,5554549.55751931
21,5,0,0,3,8,2039808.52873073,4970329.29632922
22,4,0,0,6,10,1804272.61451424,6784041.48128846
36,6,2,1,4,13,2642100.08256511,6918879.703088901
34,1,3,2,3,9,1630312.17475436,6604759.31906209
12,5,2,1,0,8,1547365.99927434,7130666.18128688
22,0,2,0,5,7,1780081.58678642,4839144.903569
22,1,2,0,7,10,2309761.24389388,5307676.02674014
22,2,1,2,5,10,2096614.77414969,5461331.5217708
14,1,2,1,2,6,2001443.7411912,8291287.37257515
31,6,3,0,3,12,2390089.25617399,6322057.053809901
11,5,1,1,3,10,1889587.81889438,2304625.26748716
38,1,3,2,4,10,2187923.37515182,7484408.33943211
31,4,0,2,4,10,1383954.67552572,5040992.81714084
19,3,1,0,1,5,1611831.56780121,4959324.93666195
31,3,1,0,0,4,1063995.78092305,6815269.47448265
25,6,2,2,5,15,2621340.25762044,9689122.23317892
33,1,2,2,4,9,2022305.3513952,3786522.73410575
39,0,3,2,7,12,2282386.09661547,8746109.29374168
12,6,0,1,7,14,1873923.73505914,6113667.12795912
40,0,2,0,1,3,1200402.44745669,3180653.35008985
35,4,1,2,6,13,2283135.93220478,9133017.33734651
30,2,1,0,5,8,2117615.43318464,4902645.68959178
11,6,2,1,2,11,1951055.54655957,7966736.87805769
35,4,0,1,0,5,1685888.61465729,3960318.29366195
19,6,0,0,2,8,1817976.64492541,6722018.75953916
37,3,2,0,1,6,1684638.80614944,5697009.98261806
37,4,0,1,4,9,1708219.49879706,3569634.40236862
35,4,0,2,4,10,2158024.14836325,9526014.59524197
21,5,3,0,3,11,1233875.59747456,6234186.93924572
25,2,1,1,3,7,1916204.18127746,5817344.37686815
30,3,0,0,4,7,1657982.72125194,6982060.08030176
16,2,3,1,3,9,1778869.26033557,5442038.9084453
30,0,0,2,3,5,1058286.07043733,6040244.66959725
18,6,1,2,7,16,2342988.17142102,8858128.81830582
28,6,2,2,1,11,2310929.57629289,7860753.20211414
18,2,1,2,1,6,1937078.62913176,5979761.44175978
21,0,0,0,7,7,1641440.91439033,3519008.28132073
19,1,2,1,7,11,2290522.66736682,3749239.50090813
12,5,2,2,5,14,2057598.52617019,6845904.88468059
16,6,1,2,2,11,1680366.92499459,7254195.59198138
26,0,0,0,7,7,1375727.26463075,4734028.54973661
12,2,0,1,4,7,1274388.95602639,5912514.77453999
30,6,2,2,6,16,3867106.14038649,9875886.08370316
25,2,0,1,4,7,1673459.28160022,6244106.07835727
21,4,2,2,1,9,2260171.67052532,5145593.67347669
10,6,1,0,0,7,1802962.36468978,4856105.74449032
40,3,1,2,3,9,2212029.85823872,4621764.80085643
25,3,3,0,1,7,2013886.78718201,6271106.42405016
30,2,1,1,7,11,2477433.26177662,8841366.0243218
40,2,3,2,0,7,2162122.48529357,5309552.45000353
19,3,1,0,3,7,1598932.82727268,7286986.10566452
21,0,1,2,6,9,2299529.36098829,8247369.83075328
39,2,0,0,5,7,1991367.9626955,3747609.48808075
21,5,2,1,1,9,1614154.48192468,3655704.54498691
32,6,0,2,4,12,1517182.05259961,8564009.62271342
14,5,2,2,7,16,3372159.30861327,8774723.30017929
20,6,1,1,3,11,2730965.30510235,5906700.00918989
28,3,0,1,0,4,1507003.63338722,5368332.73944155
38,4,2,0,0,6,1717885.22141258,7281283.72767829
35,6,0,1,2,9,2102996.87371079,5757697.64116363
12,5,2,0,4,11,2577107.3238828997,6844413.85117952
25,0,2,2,0,4,1569344.83016335,2426943.80348721
18,0,3,1,2,6,2175329.15797448,3537573.76393481
25,6,1,0,7,14,2923493.68448016,8020877.49766934
15,5,0,2,6,13,2570736.35032168,4377629.17529292
11,1,1,1,3,6,1752370.39914238,4730507.54135055
29,1,0,2,3,6,2036403.30195307,5458231.81697245
33,1,0,0,0,1,815186.944367864,1617422.45932873
24,6,1,1,2,10,1903416.47255618,6554049.73718663
22,4,1,0,5,10,1803953.92160438,8256212.49357272
22,3,3,2,6,14,2498221.33024832,5487225.22529256
25,0,3,1,4,8,1793522.28629555,3917642.90094208
22,6,1,0,6,13,1845683.77632641,6290471.16949495
22,6,0,2,4,12,2486988.02359431,6687583.15927314
16,5,0,1,2,8,1545138.01725923,5522684.34468081
39,2,1,1,7,11,1946692.7163125,7429358.50364819
18,2,1,0,5,8,1866630.13114943,2953648.3108714
32,0,1,0,6,7,1729757.85494541,7311773.15119134
33,6,1,2,5,14,2378039.06391899,7215011.30241667
38,5,1,0,5,11,1815412.54029454,11129395.9674244
19,2,1,2,1,6,1361741.29237536,4558955.68277887
14,3,2,2,2,9,1357574.3781647,4506601.57355319
24,2,3,0,2,7,1887141.23138569,6419575.79538727
32,5,2,1,7,15,2897400.25032291,8926039.61904326
17,2,0,0,7,9,1919107.31490943,5578333.40813839
10,4,1,2,3,10,1658635.45142798,2429265.45230159
12,3,0,0,1,4,1422477.38908082,2603400.65239822
17,6,2,1,5,14,2761669.01628093,9140455.24518471
11,4,1,1,5,11,2383718.83181675,3824132.63372562
18,3,2,0,1,6,1298179.78328838,4960211.15801365
31,6,3,1,3,13,2861332.12179995,11493567.0604517
20,4,0,2,5,11,2186067.27658144,6237213.08377868
31,0,1,0,7,8,1554792.83911651,7250092.28146232
10,0,2,2,2,6,1438056.31492692,5268115.65357496
30,1,3,0,5,9,1754172.28358367,5847317.95585368
33,6,1,0,3,10,1587843.66292147,2393752.8765009
21,5,2,2,2,11,2222495.47556064,8693479.88966856
15,1,3,1,0,5,1516947.91647908,4781885.66093217
32,2,1,0,7,10,2117275.06907982,6895436.1517157
12,6,1,1,7,15,1943808.74625569,9940705.32069654
11,1,2,1,5,9,1550280.86444044,6273303.05671263
33,6,2,0,0,8,1699648.20958349,3803755.94349975
33,6,1,2,5,14,2532222.71998128,6082918.961699099
25,6,1,0,5,12,1807227.94504685,1488663.51959512
22,3,0,2,3,8,2079814.23152832,4393147.81768863
35,4,2,2,2,10,2255629.86527075,7314920.48986818
19,2,0,2,1,5,1579205.42411176,5844258.86517316
33,2,0,2,4,8,1626413.39717851,2122767.43572822
17,6,1,2,2,11,2507431.69153364,4297354.63778706
30,3,3,1,6,13,2360366.36977269,6146626.5398417
22,4,1,2,4,11,1931796.31314859,8740080.75760487
15,3,2,0,3,8,1367741.75429041,5483815.82913001
18,3,2,1,4,10,1513311.33928288,2907310.83747112
39,4,3,2,5,14,2479081.80048641,8502893.441470401
18,4,3,1,7,15,2275389.43717601,8660977.45931813
10,5,3,0,4,12,3317073.48048658,4670642.19185327
40,3,2,2,1,8,2066271.33163748,5556013.95214727
26,5,1,1,0,7,1873745.87689949,8289279.31500457
21,1,0,1,4,6,1640446.78583007,4774861.97285616
15,0,0,0,0,0,690627.133598651,1780619.31549509
30,5,2,0,4,11,2436408.20195052,6684796.58532603
19,0,2,1,4,7,1763519.90819926,3250445.79565239
35,6,0,2,7,15,2948100.01589188,9471921.08158984
28,2,0,2,1,5,1288751.96928068,4943261.71020537
21,3,3,1,0,7,1303468.43506114,6142663.81154659
40,6,3,2,1,12,2307334.34389863,6324253.71565035
31,0,1,1,2,4,1201380.67173261,6825521.53152185
26,2,3,1,2,8,1752297.78721135,4327574.13695017
14,5,1,2,1,9,2956843.71768267,6170784.069387999
26,1,3,1,0,5,1554737.04787853,4708663.88069428
40,2,0,0,3,5,1795383.15595611,7395543.78045406
34,3,0,1,2,6,1899221.6588253002,4750269.30324742
30,0,1,0,1,2,902323.843689285,3499037.51865569
40,5,1,0,7,13,2379305.2322342996,7896423.45666395
13,1,0,1,0,2,1224175.71923215,4268306.79940994
31,2,2,1,0,5,1374687.0815116002,2962492.76948661
17,1,1,2,6,10,2435955.98191349,6246980.86634794
24,4,3,0,0,7,1521559.48912843,5501104.99979715
28,3,0,1,3,7,1861152.02033232,7864598.92243495
35,1,0,0,5,6,1360624.10863953,3868692.43982026
28,2,2,1,0,5,1879671.20594499,5734704.48826032
23,5,0,2,4,11,1938111.50934789,3691522.15934721
22,5,1,0,6,12,2118922.93960775,6285825.46750046
14,0,1,1,6,8,1297511.00050413,6154335.42435598
32,2,3,0,6,11,2593462.69064945,6736410.10761946
13,3,1,0,2,6,1046123.86407847,5006102.66913593
29,5,0,2,7,14,2430392.67489447,11409495.460167998
26,5,1,0,2,8,1582167.04329203,5943567.23076846
34,0,2,0,3,5,1868900.78738533,5875464.0870936
21,0,2,1,1,4,1155398.22660226,5545488.16462104
28,3,2,2,1,8,2181442.8830128997,3666240.0098717003
29,6,1,1,1,9,1788229.04638258,10057036.98753
38,2,2,2,4,10,2415146.81463556,2683814.5169995
38,2,1,0,2,5,1561367.37668483,5936930.5153508
19,0,2,0,4,6,1892275.9590967,5929711.67710464
24,5,2,0,0,7,1601967.94420647,4443829.77123426
37,0,2,2,7,11,2476241.73921707,5728599.81966347
32,6,0,0,5,11,1764804.53928665,9353892.93187642
15,2,2,0,7,11,2766238.28966535,9397696.39285937
16,4,2,2,0,8,2100836.23488277,7305013.29070503
40,1,0,1,5,7,1900217.79850121,6792971.26466226
33,5,1,0,7,13,2815394.78546207,6243479.58112212
19,3,0,2,1,6,1946265.66139529,4139230.02635013
12,4,2,2,4,12,2442069.42251739,6294096.44860072
11,1,3,1,2,7,1653584.86787358,5150297.93257145
11,4,2,1,6,13,2076736.68465072,5786745.98809599
25,1,3,0,4,8,1775176.81655399,2727451.3868223
20,0,2,2,5,9,1902487.83272723,7076584.35692295
31,3,1,2,4,10,2371100.9731753,2962007.14086296
34,3,2,2,1,8,2482172.17044957,7418621.92176267
36,5,1,1,5,12,1572213.81934127,6622755.99583766
28,5,3,2,0,10,2083061.67300847,7768554.83710265
17,5,2,2,7,16,2066842.44803041,10227306.57827
31,3,2,1,0,6,1613151.00397129,6752340.451580999
33,5,1,2,4,12,2681060.60069547,7142704.81646005
33,0,0,2,6,8,1626688.96164559,3780129.08241633
19,2,3,1,0,6,1739930.58945171,4941292.48501793
28,1,0,0,1,2,970613.1188833991,3516593.78722682
26,1,1,2,4,8,1704929.57683346,2126866.68005887
31,4,2,1,3,10,1728102.6324153,6874427.176706401
21,0,0,0,4,4,1053843.25977428,4710533.18674257
40,5,3,2,5,15,1758112.55704398,9426596.06712592
23,0,3,0,3,6,1168866.92423712,2365333.43564713
23,6,3,2,1,12,2267718.46747774,10009781.5981935
27,1,3,2,3,9,2073075.97055163,7302382.71418
13,3,0,0,0,3,1641090.58146559,4632487.56353906
35,3,2,2,7,14,1882381.48617695,6287255.775445599
13,5,2,1,0,8,2298368.08435974,6678612.19100726
10,1,3,0,1,5,1248360.1131620002,3776999.95905916
22,3,0,2,7,12,2206072.56896564,4769924.25901559
20,3,0,1,4,8,1843074.24566063,2979890.46877411
38,6,2,0,1,9,1327748.39989505,5207039.31944975
32,1,2,2,4,9,1651214.33193946,5465778.04454266
32,0,3,2,3,8,2274283.46564059,4354852.72603336
20,5,1,1,5,12,2430560.84072196,4956510.45816172
26,6,3,0,4,13,1641209.41390312,7295092.08370205
26,5,1,0,5,11,1593340.50120504,6198874.75024723
12,1,0,1,2,4,1306379.85793087,4082053.16211217
10,0,3,2,5,10,1680515.25805275,3222392.48101022
30,0,2,0,7,9,2127755.57789485,4990987.14038787
18,2,3,1,2,8,2044282.03851358,6106665.08015865
35,2,0,0,5,7,1670440.36049235,6028079.34857552
19,2,2,1,3,8,1792557.75297263,4309741.63890081
30,5,0,0,0,5,1976718.79317757,4124403.84661679
11,6,1,1,1,9,2169677.15898567,4719658.80172666
30,1,3,2,4,10,2223683.33526151,5449593.11804878
16,3,3,1,0,7,932250.3922594,7417600.60579958
19,6,2,1,4,13,2348842.93721322,5873252.87012415
37,1,2,0,0,3,728689.6925270241,4090054.77533985
24,0,0,1,5,6,1411231.0585176,3718487.02810649
19,2,2,1,3,8,2071201.02354209,4352747.1737976
34,4,3,0,7,14,2269894.2693968997,7485563.12400653
21,1,0,2,0,3,1582900.47372564,2322019.38860119
17,1,1,2,1,5,1612821.12804423,5220218.03043749
27,1,2,2,1,6,1895906.13612225,5689941.38559565
16,3,1,0,1,5,1640991.10030348,3902660.60832347
36,1,3,0,1,5,1511723.92205341,3205922.42145837
27,5,0,2,3,10,2265731.76924729,6032774.79532125
26,5,3,1,6,15,2027192.54680965,7202786.90757936
34,1,0,2,5,8,2083902.40245599,5615887.45516466
28,5,0,2,6,13,2425033.32538443,3849744.67839556
20,4,1,1,3,9,1887834.92336577,6850902.59816971
25,6,0,1,2,9,2053976.14197718,7017239.84749602
29,3,1,0,7,11,2401314.15433439,4811746.57175973
13,6,2,1,0,9,1765085.13916915,4351534.8118541
28,0,2,1,5,8,1552039.31460831,5002942.99105509
18,5,3,0,5,13,2426321.55687641,7483656.26528272
29,5,3,0,7,15,2355319.91650919,7277660.43939172
32,1,0,0,6,7,1617986.01470384,8297282.3387287
22,6,3,2,6,17,2947272.0724130003,5192529.40154175
29,1,0,2,1,4,1352181.2848651002,4903028.81379714
12,1,3,0,4,8,1121146.83030561,5342328.88482716
18,3,0,1,7,11,1692002.49709716,5964471.55544351
20,5,0,0,6,11,2126711.10969668,6114363.28434797
30,5,0,2,2,9,2097682.38495603,8830265.60437727
26,3,0,0,7,10,1772450.48232807,5933758.23637391
27,6,1,2,4,13,1073597.2711031,7329414.768778301
28,0,2,1,4,7,2094407.37060701,3573976.55158139
31,6,1,1,7,15,2379814.76910922,6068264.32760656
14,6,1,1,0,8,1826263.86721616,6532968.85734744
40,1,3,1,0,5,2051503.99134287,616428.641208115
28,6,2,1,2,11,2016535.36625999,5866176.62584338
32,6,0,1,6,13,1735710.16150152,7827659.70340534
19,0,2,1,5,8,1941488.46874474,4915668.15489752
29,1,0,2,0,3,1396698.80527132,2869417.91369537
40,0,3,0,6,9,2209345.75241592,6403154.55169354
20,1,1,1,1,4,1776650.43865947,4719918.996935501
17,5,3,2,7,17,2349337.54780816,10692047.626169698
34,6,3,1,0,10,2481437.35431079,6780193.98908615
15,5,1,1,7,14,1506853.24905268,4830088.59275693
12,6,1,2,1,10,2080781.34142831,5582617.51302549
25,5,0,1,3,9,1590120.2978598,3217338.12003671
37,4,2,1,3,10,1340728.05364035,9288428.52880136
13,6,3,2,7,18,2559434.60104137,10231142.114941198
11,6,0,1,4,11,1701130.69461373,6086576.42259849
31,5,2,0,3,10,1941682.32857719,6445089.8482543
20,6,3,2,5,16,2438306.13796411,5979037.18733654
29,2,0,2,5,9,2048303.94274888,5994912.88019043
28,0,3,1,5,9,1715618.24211114,8075177.43350633
34,1,0,0,1,2,1357883.61622849,5468665.49052412
29,4,2,1,0,7,1684912.7241185,3720932.83468582
16,6,3,1,0,10,2003902.08820586,6394423.98248539
17,0,3,2,3,8,1917768.10809508,6523120.52643598
38,0,3,0,3,6,2203592.68428291,6886207.46469194
32,6,3,1,6,16,3378903.1373813,8826428.17148556
29,4,0,0,0,4,1884757.60956624,2445453.54136082
17,4,1,1,2,8,1500667.38260646,5416694.48532757
12,0,2,2,6,10,1414055.32957246,3939798.07107894
14,5,1,1,3,10,2036276.89466723,4379245.68224126
21,2,1,1,0,4,1476477.91268605,5919326.15500184
11,3,1,0,7,11,1787244.17144259,8011501.50119314
19,4,1,0,7,12,2250261.07621915,5706540.92649028
24,0,3,1,7,11,1794616.44548117,7546228.2719242005
33,2,2,1,7,12,2491170.37061826,5114127.91040546
13,2,3,0,3,8,2006009.23740657,5154071.10538394
23,5,3,0,5,13,2381574.85302022,4038767.51649955
22,3,1,1,4,9,1926122.92619414,7841989.73105454
38,2,2,2,2,8,2008541.84447651,4449766.16658624
26,5,1,0,6,12,1952387.58225471,7216189.74176725
14,5,1,1,0,7,1657024.47692162,6765909.86894211
19,2,0,2,3,7,1638598.14973253,5524472.48954634
25,2,0,0,0,2,1825425.03426068,2386883.45591351
17,4,3,0,7,14,2704007.76452198,4578547.45978444
15,6,3,1,1,11,1609951.30888251,9938525.1244806
24,0,2,2,7,11,2079634.15491429,6061752.95612429
17,5,3,1,3,12,1986143.65453857,5618425.34407341
18,1,0,1,5,7,1335596.6567016002,6239730.70849821
28,5,0,0,0,5,1396572.43522676,3728905.17156389
26,5,1,2,6,14,2288784.88919832,6815163.42397951
14,4,0,2,7,13,1604198.27733826,3965307.15095207
27,0,2,1,4,7,1487295.68156011,7402054.3020481
35,6,2,1,3,12,2180179.72916666,2525415.82936203
28,0,3,1,6,10,2450185.8542602,7657267.5231248
37,6,3,0,3,12,1744250.54400026,5501826.38294947
11,1,0,2,1,4,846309.5999811459,3979548.33983143
28,6,2,1,5,14,2498706.42390048,6003818.97741714
19,5,3,1,5,14,2548546.41000198,4258543.01666253
30,6,2,1,2,11,2455772.37008551,1470165.51857133
23,2,1,2,5,10,2022998.11866334,6247302.08333383
25,4,1,0,0,5,1646588.04319645,4454521.35276127
29,3,1,2,3,9,1651042.99304001,4479581.43587294
26,3,2,0,4,9,1584001.41414017,6224808.49677092
12,1,2,2,4,9,1834300.08670605,5004042.22733034
40,3,0,2,6,11,1887577.24895711,6457105.84729081
15,1,0,1,2,4,1340899.11765127,4957763.57461472
21,6,3,2,1,12,2229165.47600449,6496311.10129988
20,4,1,2,4,11,2024939.65022295,6690825.77509096
29,6,3,0,2,11,1976207.78670125,7528132.76228261
31,5,1,0,4,10,1995151.33989342,6190293.84851052
34,2,3,0,5,10,1919709.72537081,6192725.29925211
15,1,1,2,1,5,1742203.26187739,2219716.6648613997
19,4,1,1,6,12,1874805.72709315,5700459.7294897
29,5,1,2,2,10,2394908.79055314,8490526.52132917
35,4,0,2,5,11,2217782.04818697,5423971.51349832
35,4,2,1,0,7,1862163.52015073,3383979.22081988
36,3,3,2,1,9,2065549.20499726,3989046.96278713
37,0,2,2,1,5,1653180.18858743,5686488.64675292
23,1,3,1,4,9,1880088.94841058,6782575.35272185
13,6,0,2,5,13,2845769.92003374,3453565.26019713
39,0,2,1,2,5,1360936.87124879,5464346.5655585
38,4,1,1,5,11,2477367.06750273,7286609.34554054
25,4,2,1,6,13,2211766.49107607,10065162.474133098
27,0,0,1,5,6,1711088.41792472,3773845.90201194
17,6,1,1,5,13,2096421.43080936,5460458.03341248
20,1,2,0,5,8,1190225.46437517,4560385.08326214
29,1,1,0,2,4,1447421.60929938,4568172.3891388
31,6,3,2,1,12,2240339.58455405,5424969.08696744
14,0,3,1,3,7,1732793.78949279,5321911.03700346
34,2,2,1,1,6,1927532.9939869,5726453.27515374
21,1,3,0,2,6,1795065.80945107,1979921.23835471
26,5,0,2,2,9,2702157.60215994,4449576.28168931
38,4,1,2,6,13,2085630.76493538,5554543.63341086
33,2,0,0,6,8,1664393.66595124,5729934.40809378
39,2,0,0,1,3,1072808.30124763,4809838.78485058
19,1,1,0,5,7,1733100.19085548,2946636.34252047
38,4,2,2,2,10,1592442.88452461,5875094.20648227
11,0,2,2,0,4,1971528.46976912,2652383.42886602
23,3,2,2,2,9,2216299.94776315,6733054.07662846
19,3,0,1,5,9,1656604.22831726,3688638.9739584
35,4,2,0,3,9,1887622.28606558,4668010.45622437
18,6,2,2,6,16,2444227.32613556,4826713.99582703
22,1,2,0,2,5,1490159.35710853,5547004.10442606
30,0,2,2,1,5,1269407.32260069,4775576.22190959
14,3,2,2,0,7,1665717.16412532,6798676.37952278
15,2,1,0,3,6,1995699.1504546,5346575.90565354
19,5,0,0,0,5,1719215.34210106,3871778.09287118
40,5,1,2,1,9,1727720.61971056,5709322.37832848
15,1,1,1,0,3,1129106.55162398,4597354.04468274
15,2,1,1,1,5,1589326.43864441,3636856.18255034
40,2,0,1,3,6,1297946.54892313,3630004.75592679
16,1,2,0,7,10,1823578.06833765,5798006.27283132
19,4,1,0,1,6,1606899.27184458,3966770.31951494
18,6,3,0,6,15,2745109.38964119,6012194.36776828
31,5,3,0,5,13,1862933.15454078,8668988.87891817
16,5,1,0,1,7,1783081.78494351,2563622.95202802
12,1,3,0,3,7,1897915.98756574,5668388.52239304
21,2,3,2,3,10,2253511.79094763,3426756.60526441
38,1,0,2,0,3,933944.518703809,4851909.98620938
26,0,3,2,1,6,1541206.14017262,4361266.28888902
10,0,2,1,7,10,2111946.32559552,4574489.44562509
10,5,0,2,0,7,1759917.58191106,3592326.00817764
37,3,0,1,2,6,1578088.76039399,5917696.2129818
31,5,2,2,3,12,1777755.70743366,6576006.12140996
33,2,3,0,2,7,2132801.48361509,3676027.81592801
17,2,2,2,0,6,1706933.19237869,4490284.78584153
34,3,0,1,6,10,2305463.68311877,6648078.29819981
20,1,0,2,0,3,1201208.05841357,5414220.58937399
40,2,3,2,4,11,2012131.17329259,5140816.92824045
26,1,0,0,5,6,1133625.25904251,1758164.66412645
10,0,1,2,3,6,1480318.90289915,5592977.95291069
30,1,3,0,0,4,1169835.28974438,3608627.62798077
38,0,1,0,4,5,1439035.60979351,6243212.63154357
13,6,3,1,2,12,2292531.92442701,5920941.10258671
22,4,0,2,7,13,2287208.79355997,6994706.22543677
19,5,0,2,4,11,1944363.53632348,5735369.13382994
19,1,1,1,1,4,1424065.98805925,4586996.57248991
32,2,3,1,4,10,1761039.64749786,6479372.13335465
40,2,2,2,6,12,1866448.69400487,8897505.72082312
34,5,0,0,4,9,1273013.03909623,4524064.70974037
15,3,1,0,5,9,1754649.16981608,4181918.40957219
12,1,0,2,6,9,2269930.25448222,6730237.54280369
24,5,3,2,1,11,2246806.67679461,6830915.36039112
28,6,2,2,5,15,2747267.2453364,8836880.57807375
10,3,2,2,5,12,2174975.84338531,4176428.43340512
14,2,1,0,3,6,1425312.32521162,4248618.52815713
30,6,2,1,1,10,2010819.9222356998,6028296.85950666
28,1,3,0,2,6,1507936.78864628,6397400.21861609
26,3,1,0,3,7,1568710.87415081,3771457.39766161
25,1,0,2,7,10,1932130.5933985,5550700.89226956
38,4,2,0,4,10,1604711.34253993,4221751.15221277
36,5,0,0,7,12,1794657.54607458,5698391.6553197
26,4,3,1,0,8,1912267.27687075,4911220.51098042
10,6,0,0,2,8,2333670.06783516,7099275.10752112
18,2,2,1,1,6,1871364.70714461,2996913.80972748
21,4,1,2,4,11,2257754.97590472,3248555.63779638
22,6,1,1,4,12,2483523.36151544,7568656.639223101
16,3,2,2,4,11,1501728.68966762,4125274.60499328
19,2,3,1,0,6,1679321.85452139,3077878.29679695
20,5,1,2,3,11,1862103.93221496,5759273.3536591
12,4,3,2,0,9,1406727.99264272,4809655.93827476
25,5,1,2,0,8,1537997.0300403999,6479418.50209364
35,1,0,1,1,3,1239950.55401281,4867787.08866106
13,3,3,1,7,14,1717857.99931604,6223588.88091027
28,4,0,1,6,11,1720886.7257922,6534165.76150157
17,6,2,2,2,12,2492764.6121729002,7569930.36883803
10,4,1,0,3,8,1951127.67568922,4388217.46075442
12,0,1,2,0,3,956203.457552119,5747922.04567612
38,4,1,1,0,6,1813921.26861939,5894667.85650944
15,3,2,1,4,10,1864733.63699319,5911917.34523473
38,5,1,2,3,11,2645296.77280691,6287655.22706957
21,6,2,1,2,11,2637791.63589496,6065790.63250823
24,6,1,2,7,16,2539711.84431235,7224196.75861622
36,2,2,2,3,9,1696834.8913497,8090504.56980518
40,5,1,2,5,13,1665060.31990636,6399224.55753105
35,3,0,0,4,7,1406047.48191576,6629713.31711229
21,4,3,0,5,12,2138842.2132349,4034367.30376603
33,2,2,1,7,12,1837419.17547254,6129396.53899714
27,4,3,1,3,11,2003866.08688173,7207494.80302816
35,2,0,1,2,5,1091921.27292011,4065627.62939945
25,2,3,0,3,8,1345746.52041676,7495684.44548603
29,6,0,2,1,9,2077217.45559396,6306988.96119023
35,2,3,1,1,7,2246028.04017162,4690092.321705099
14,5,2,2,2,11,1829466.6823125998,7873598.57982036
26,5,1,2,0,8,2250139.67600719,6882695.39664257
20,4,1,0,4,9,1568892.52169583,5167060.45679545
14,4,0,1,5,10,2325646.94285875,4476563.45270565
16,0,1,0,7,8,1891969.53280389,5978285.70807953
24,3,2,0,5,10,1593250.08476362,4669965.18470169
36,3,1,1,4,9,1429734.72724604,6713007.0702914
36,1,0,1,0,2,1422466.89781299,4582086.47337772
10,4,2,1,6,13,2449721.77222128,8941642.062013699
10,3,3,0,4,10,1681656.38181217,4514685.56162165
30,4,1,0,6,11,2269405.88369073,7696341.11475368
13,6,0,0,7,13,2747478.98773428,7985314.07618323
13,3,3,2,0,8,2013372.03358692,2241489.06198111
35,2,0,0,6,8,1829310.4242063,6081569.44903002
35,3,3,0,2,8,1923294.95739068,5141313.26397841
22,5,3,0,1,9,1979577.95886381,4745836.42923273
20,1,1,0,1,3,1635079.99026867,2057688.18476725
20,0,3,0,0,3,908585.44834608,6866106.84669387
16,4,0,2,4,10,1573933.28399697,5649071.40347165
36,3,0,2,3,8,1841576.73597422,5683723.62772105
21,4,0,2,7,13,3164999.7855401,9306474.4814564
38,2,3,0,3,8,1857550.71441404,4305655.56647181
30,1,2,2,6,11,2319053.85783286,4791621.82617795
35,3,0,0,1,4,1652480.76215947,2854736.43615289
33,1,0,0,7,8,1265091.8260563998,5112600.45438413
28,0,2,2,1,5,1597448.31174105,4461390.68148132
17,2,1,2,2,7,1972273.05639503,5509353.043345599
37,4,0,0,2,6,1964897.85955189,6230278.9347446
30,0,2,1,7,10,2404706.41030371,6530010.03535832
36,1,3,2,3,9,1835159.63699635,8148507.914932201
33,4,3,0,4,11,1871828.17145794,4358930.76809892
25,6,2,2,3,13,2512169.00519333,5318787.04373569
16,6,0,2,3,11,1872205.83616966,3921561.38942319
36,1,1,1,1,4,1362592.11880304,6788865.58410265
16,2,2,0,4,8,1614259.51787092,7700957.58277742
22,3,0,1,6,10,1489313.42033263,7969785.25884295
34,2,1,2,1,6,1672359.61068323,4717956.80496647
34,2,3,0,0,5,1277709.33677359,3904244.92539766
35,3,0,1,5,9,1929442.22253676,6678647.13420926
34,1,0,0,4,5,1902933.70979664,5095538.25800159
31,1,2,0,1,4,1364708.54802827,4366473.76032197
15,4,2,1,6,13,1672266.4558115,10013538.5506574
12,6,0,1,0,7,1646996.72425253,5450342.82236833
39,4,3,0,4,11,2784810.13532888,6685972.48114453
37,3,3,1,6,13,1778593.15991188,6226501.4355075
29,0,0,1,3,4,1424884.66886401,3520870.66333026
13,1,2,0,1,4,1238052.72737416,3862204.87366527
25,5,2,1,5,13,2028995.31954437,11788944.1526845
23,4,0,1,0,5,1503906.40602862,2639230.28702315
17,0,3,1,5,9,1841575.47651207,6908740.89707387
17,4,0,0,6,10,1567549.79437399,2766770.74460375
17,0,3,0,0,3,1070151.95866712,5049203.08148962
11,4,3,1,0,8,2411101.93277019,5074591.11493984
27,2,3,0,3,8,1639650.22073791,7328333.97471719
28,5,2,1,5,13,2993740.8832262,7674498.48875437
10,6,0,1,5,12,2203021.77456815,4774366.37923469
23,3,1,2,5,11,2242982.28586056,4744593.69001009
34,1,3,0,5,9,2153423.40445524,7230488.19287919
10,4,0,2,4,10,2422431.27028556,4964494.49918809
33,5,1,0,6,12,2673182.87228017,9299576.15258453
11,5,1,1,1,8,2151603.66853424,2427639.73147765
14,6,2,0,1,9,1951399.36217392,6689254.07918901
30,4,1,1,5,11,2460634.39262059,4723393.73842377
13,4,0,1,6,11,1535007.2663025,7482346.60702164
36,1,0,2,4,7,1694352.9441138,4162575.87252846
28,1,2,0,3,6,1304444.20476401,6122471.28996278
12,3,3,1,6,13,2079554.90085726,4203318.51113371
40,3,1,0,0,4,1731339.72774332,3032856.59032734
33,1,1,1,6,9,1814722.3648384,5996389.92455809
23,5,1,2,5,13,2553885.82120003,6010319.94277948
16,4,0,2,6,12,2173263.75832738,6144520.240070901
14,4,0,1,6,11,2200435.78691628,3385065.26698741
31,2,1,1,5,9,1987089.72330496,7161555.59840637
27,5,3,1,1,10,1373789.29583472,4942209.70593756
24,2,3,0,6,11,1746500.58821431,5343267.1260171
40,1,3,2,5,11,2647763.74631398,5259731.07585124
17,0,0,1,3,4,1212426.32148148,7903145.5258349
27,3,1,0,0,4,1526809.32754613,1338477.20437211
13,0,0,1,2,3,1198311.65131462,2717583.96633617
29,6,2,2,5,15,2661354.50895336,7941497.29536459
27,4,0,2,6,12,1719561.66377223,8881767.62683675
24,5,1,0,4,10,1844122.89402376,8198768.33543448
15,0,2,1,0,3,1705840.23804502,3175303.10103246
18,0,3,2,3,8,2276157.49972119,5665477.115507
16,2,3,2,7,14,1860802.71723844,5365870.37036006
34,2,3,0,2,7,1978624.36578025,6181702.12341276
33,5,0,0,3,8,1767992.10814471,4010450.82788984
31,0,2,1,2,5,1510582.19242837,4620606.56735643
31,3,2,0,0,5,1582346.77687006,4444766.53133831
33,4,0,1,6,11,1867018.00465158,8310087.50593398
23,2,0,2,1,5,1684388.33286845,3724295.90485915
37,0,3,1,0,4,1502665.1906751,4279741.74100102
30,6,2,1,6,15,2685823.23807742,5773890.81342145
21,6,0,0,5,11,2314020.50933098,7320624.08604066
28,1,0,2,6,9,2078975.22567773,4919257.56292951
16,1,1,0,4,6,1358159.88315325,6920825.12253216
38,3,1,1,6,11,2139069.05150681,7101993.01542312
11,4,2,2,5,13,1202895.62201585,8832869.22662291
15,3,1,0,3,7,1100905.54759807,5322377.01773324
20,5,3,1,6,15,2356571.78605662,6765700.96454716
28,0,0,2,5,7,1648390.66381957,3113423.41129148
18,6,3,2,4,15,2945979.67297066,6964161.13510329
15,4,2,2,1,9,1903105.2313183,5697291.09434155
35,6,0,2,2,10,1494357.17938284,7115041.9311192995
17,2,2,2,7,13,2126893.75400189,8495144.93314282
16,3,1,2,3,9,1637761.32439301,4468409.62293892
13,5,3,1,5,14,2054870.24773517,8056940.88308785
26,3,0,2,2,7,2179380.96361689,4913480.03109805
28,6,0,0,3,9,2467264.90607892,6072906.58223873
37,5,3,0,2,10,1849471.99727698,8853239.15127149
14,1,0,0,1,2,1151342.46783454,4326420.52897994
23,0,1,0,1,2,1069163.52678191,5885134.5590056
26,1,2,0,5,8,1743321.93888533,6742513.684768599
36,0,3,2,7,12,2503489.46175772,6625639.08836534
25,1,2,1,0,4,1133835.62174529,2745739.10403972
19,3,1,2,1,7,1481909.29978181,2949665.00401639
15,6,1,0,5,12,2115133.67637114,5619962.23218138
29,4,2,2,6,14,2232113.46143061,7898866.51091118
14,5,2,2,7,16,3029978.39813473,4586317.44880673
16,1,1,1,2,5,967379.0419832091,6049638.99226526
18,3,3,0,1,7,1617490.49334374,5380375.24802264
39,2,0,2,6,10,2072356.56489699,5492843.79404389
23,4,1,1,1,7,956063.286981437,7202808.43787997
32,6,0,1,6,13,2142676.08351377,7321600.19505212
12,2,2,0,1,5,1624705.74133518,2716193.41307748
39,6,1,1,7,15,2911276.88314125,8586603.4576252
19,2,1,1,5,9,1727308.09406336,7066081.31443007
29,6,0,1,6,13,2350830.87806644,7844276.35025854
29,2,1,2,2,7,1812256.31381651,1988061.86422422
39,3,0,1,0,4,1216104.69114575,7086529.67658788
10,6,1,0,0,7,1491671.87781963,3908102.87792933
20,4,0,1,5,10,2270578.03895124,2912878.12731152
27,5,2,2,2,11,2466045.73472852,7553909.83599415
19,5,1,1,1,8,1560400.68910557,5518755.21522539
25,6,0,0,4,10,1738180.43986895,2960545.12302542
16,3,1,2,3,9,1612913.91830712,8166781.80400563
34,2,0,2,5,9,1788979.90829055,2866025.35338364
38,6,2,1,7,16,2621703.52933224,8382791.13555307
26,6,1,2,7,16,2748904.98622854,7583843.18021315
23,2,0,2,5,9,2083350.0935667,7948479.20065326
23,0,0,0,6,6,1720707.96040065,2810171.86558252
28,4,0,0,3,7,1908225.49881474,5452233.59049056
38,1,0,2,0,3,1346570.94064059,1681233.61437651
25,0,1,0,1,2,1272680.64269351,4661990.95512572
25,4,3,1,6,14,1833334.95508799,11633798.7833446
16,4,3,0,0,7,1804972.06497893,5443554.00136836
13,4,1,1,0,6,1807127.03388966,4720307.75473525
37,0,0,1,7,8,1618802.47553353,6085326.54279771
20,2,2,1,4,9,1551429.04992794,8048791.31030092
14,6,0,2,5,13,2558328.0319192,9243490.5858737
15,0,1,2,6,9,1846366.91932534,2656223.08644517
12,6,3,1,2,12,2505410.43971378,6509847.9374583
36,1,2,2,2,7,2179355.07571637,7050576.30764034
37,6,0,0,6,12,1757241.69983608,8050853.88963419
33,0,3,0,6,9,2135435.6355063,10867015.7959585
22,3,2,0,0,5,1414967.05547536,3542390.32732894
21,0,3,1,5,9,2624753.65820924,8863809.09509275
21,0,2,0,6,8,1858832.17320249,7341084.76478993
35,2,2,1,7,12,2235348.14042248,5948753.38444442
27,6,1,1,2,10,1727756.50102759,3674331.75250016
28,2,1,2,3,8,1738128.40067265,3186032.86010874
28,2,1,1,2,6,1555655.19333328,6834906.678686
32,5,2,2,2,11,2376103.4314786,6998697.76075879
25,5,3,1,2,11,2519460.26044815,2524907.51200182
18,1,1,2,1,5,1640866.84036311,5536562.44202441
35,5,1,1,7,14,2776194.24799616,10197642.872224199
40,4,3,2,2,11,2409007.40232397,6394847.13373565
15,5,0,0,3,8,1555451.60324118,7517552.24104632
20,6,0,0,7,13,2658124.09950867,6245377.96916939
40,3,2,1,6,12,2970266.81697032,4480269.14877056
34,1,3,2,4,10,2019476.14721117,4842923.96827648
31,5,2,2,1,10,2443851.40042595,8285360.55478647
10,2,3,0,0,5,1271255.37399272,5060932.02003704
26,5,1,0,5,11,2140014.58609292,6461748.745036701
36,2,3,1,5,11,2045665.0985393003,7103813.46125542
29,5,3,1,5,14,2588705.76517734,4294636.94970999
39,3,1,2,2,8,1983004.8734143001,3867887.91322796
21,6,2,0,1,9,1788035.2453608,6441452.93540655
24,5,2,0,2,9,1790705.98259099,6597766.79965509
25,4,0,2,6,12,2025550.88360293,4805104.18206767
15,6,2,2,3,13,3137579.48089699,5140185.41250392
28,0,2,0,5,7,1711743.97104978,3918454.56552588
33,5,1,2,7,15,2149560.18518811,10627211.437725099
19,3,2,0,2,7,1805955.33231202,5487459.08556007
27,3,2,2,1,8,1431558.37198886,514989.452326493
39,0,3,0,7,10,1955151.56447662,4373670.33813679
30,0,0,2,3,5,1161873.75578639,3078009.17080517
29,2,0,1,4,7,1500709.69863108,7738637.1558302
23,0,2,2,7,11,2462671.10129352,8242258.98295172
15,3,0,2,5,10,2246206.35333699,7746285.88859868
39,2,1,1,2,6,1879851.90624703,5591374.58301553
30,3,2,1,6,12,1478344.6988902001,7549953.40843018
20,0,3,0,5,8,1585469.52641026,7198744.55915751
13,4,3,2,2,11,1572153.19734991,7552123.29705134
29,6,3,0,2,11,1695878.73941543,6569061.25459201
33,4,3,2,1,10,2215272.97773544,5753725.27090032
32,3,0,2,4,9,1524702.78933187,4575149.63466577
21,3,0,0,3,6,2000832.09981028,3213970.18076834
30,1,0,0,0,1,1022399.72582077,3195001.11258581
31,6,0,1,5,12,2358303.22404171,2976651.30327589
29,6,1,2,3,12,2067833.82865983,8726156.53888058
11,4,2,2,7,15,2503961.99616154,7327905.95457468
18,2,2,0,1,5,1221076.49125938,5582570.60520673
39,0,0,2,7,9,2169676.22272955,7590704.22620557
28,3,1,0,4,8,1483513.56614762,5677559.73057141
22,3,3,2,5,13,1406830.77488164,6067074.49067005
20,0,3,0,2,5,1476866.42168188,6122896.59982936
38,6,1,0,6,13,2067894.67739437,6888456.23794033
12,1,0,0,1,2,1112708.38098811,3993047.6050206
32,1,0,0,3,4,1280158.64818295,7174586.31120822
38,5,1,1,6,13,2237492.19572628,9743217.43191997
33,2,1,1,1,5,1211307.02918025,4805180.1770069
14,2,0,1,5,8,1813273.67263332,3522919.22963437
13,2,0,0,5,7,1312709.67734971,3957582.03034163
14,0,3,0,2,5,1453723.00479143,5227441.78795408
32,0,2,2,3,7,1721461.99380436,7433017.25490409
21,6,0,1,5,12,2543456.91209734,9658689.94220878
39,0,0,1,2,3,1256486.93390305,4115061.65888966
24,6,3,2,4,15,2322002.87913104,9937328.93228132
19,4,2,1,0,7,1802245.37231265,4174379.41420232
14,2,0,1,7,10,1904846.58865121,7001565.42874588
24,0,1,0,1,2,1159255.74566775,4989041.3262587
33,4,3,0,5,12,2234327.35769656,8412153.35959403
27,4,3,2,7,16,2929701.2930605,11558633.0642348
30,6,1,0,7,14,2930976.14478038,6967262.0944763
34,4,0,2,0,6,1618075.67335152,4167021.76242956
40,4,2,0,0,6,1634993.78236651,4681782.60485824
30,2,3,2,0,7,1289929.54917694,6931209.62093176
29,3,3,2,3,11,2657733.36067643,7042751.385084501
24,6,1,2,1,10,2412667.0460857004,5325204.88298144
10,2,3,2,0,7,1574985.16746507,2728698.25161457
38,1,1,0,3,5,2012795.14977704,5095396.43827245
35,2,2,1,3,8,2542767.18880404,3901150.34586944
38,5,0,0,3,8,1907244.40022018,6487109.18796911
34,1,2,1,5,9,1285025.23115188,4267157.16057094
34,1,3,1,6,11,2397658.78607699,3867093.27761938
23,2,2,2,6,12,1537761.40635555,5247464.82543181
37,6,1,1,7,15,2488009.19885843,8617023.66366038
22,2,1,2,4,9,1898288.40120218,5073138.78922731
39,4,3,2,4,13,2171233.35118838,7473732.89565999
35,6,0,1,2,9,2004349.68017834,6064761.23998627
38,2,1,2,7,12,2319393.97067613,7776373.59755336
29,5,0,1,2,8,1582757.71231015,6821680.56108025
24,0,1,1,7,9,2220108.16536739,6713333.06297859
17,6,0,2,6,14,2559610.94566492,7645329.89616401
40,0,0,0,7,7,1495920.05069248,6060827.55182112
10,6,3,1,6,16,2880402.90228933,9522800.55042033
31,5,1,0,6,12,2596011.35819677,5398877.97040388
19,0,3,2,4,9,1509945.07874923,7907808.94409578
23,1,3,1,1,6,1329185.46642822,2092919.26175884
26,5,3,2,1,11,1827339.64971714,11215173.710336301
34,4,3,0,0,7,1862889.7980876,7957406.91939926
39,6,0,0,2,8,2279964.63981301,6447205.92564083
11,6,3,2,6,17,2159892.33491531,7551911.54315394
18,5,0,2,5,12,1704080.51161841,5538085.32241459
22,4,0,0,0,4,1454539.1478975,3856158.41776315
11,0,3,0,7,10,2140940.44413126,6405683.57632771
37,0,3,0,2,5,999511.776436344,3664870.82456226
18,6,2,2,0,10,2005024.71070639,5156652.89176596
20,2,0,1,0,3,1514480.37017953,1514480.37017953
26,5,0,0,0,5,1773699.93188421,6457584.470745
26,1,3,0,6,10,1877307.36070154,7902373.35818007
21,1,1,2,7,11,1548686.0832540002,8956813.79469137
38,1,3,2,0,6,1695254.44462488,5422974.02338116
28,2,2,1,2,7,1328446.45656855,4405127.14243312
13,6,1,1,6,14,1239963.93801571,6953819.79685573
37,6,0,0,3,9,1813236.46656019,2593014.54126012
18,5,2,0,6,13,1711251.58865062,8346528.782972099
20,1,1,0,1,3,1371028.35148995,4843482.02548882
36,6,2,2,3,13,1052368.77451057,8999277.23135088
21,1,0,2,4,7,1336381.86025904,3948183.95723583
21,5,3,2,4,14,2817275.59423046,7831081.41096922
16,2,2,0,1,5,1381559.34090319,2686710.87776386
24,0,1,1,7,9,2193808.62545534,626504.331035041
16,1,2,1,6,10,1997218.77900862,7292404.394454
29,2,1,0,1,4,1521561.44469952,3519693.71636891
17,0,0,2,7,9,2246821.50643166,6523414.59891682
13,4,1,1,4,10,2294895.26689915,7246657.72712331
24,2,2,1,5,10,2118244.17005874,3161712.94207842
29,4,3,1,2,10,2151634.61660073,4157351.16403241
35,1,0,2,0,3,1455635.43662555,4474595.73555394
32,2,3,1,4,10,1541699.41712708,5814997.19480285
19,5,1,0,5,11,1793184.07357709,5349189.56343661
38,1,1,2,2,6,936619.838484177,5157470.76452968
10,3,2,1,0,6,1473253.64792722,7209444.97312786
20,3,2,2,4,11,2175576.81012727,9370825.96443773
40,6,1,1,7,15,1613079.53525546,3968572.44595027
32,2,0,0,2,4,1312473.63293582,5169672.81910123
25,4,1,0,2,7,1713890.72144347,3664943.45846531
25,6,0,1,6,13,1818650.71422195,6408532.67095971
12,1,0,1,1,3,1494803.70119915,5495944.03666184
14,6,0,0,7,13,2243672.43867929,9395848.09721342
13,4,0,2,5,11,2321155.7038288,3263633.97781831
21,0,1,0,4,5,1333735.31711023,6287305.80217795
36,4,2,2,4,12,2785010.35784994,6692083.69842679
10,5,0,2,1,8,2041673.71502895,4028393.92209083
38,6,2,0,3,11,3045716.66007549,4023038.39770785
19,4,3,2,4,13,1778015.49130464,4917890.07692732
10,3,3,1,0,7,1537953.31407883,3372911.67370816
35,0,2,0,6,8,2162795.82049131,5829383.07060784
19,3,3,2,4,12,2017342.27692977,6910586.02533062
17,4,1,2,6,13,2660639.94885798,7574385.93228467
18,0,2,0,0,2,1199458.07471136,430698.387273026
27,5,2,2,7,16,2258154.13277999,6476748.78380549
38,6,1,2,5,14,2072252.51882406,10936703.0700985
31,0,3,1,6,10,1952182.47056488,9470444.16392748
11,6,2,1,5,14,2106039.99991003,8034381.81989427
34,0,2,0,2,4,1120426.57937052,6897875.80671275
32,2,1,1,2,6,1660919.97946636,3562581.66804938
30,4,2,1,0,7,1026551.85255431,4411565.35555574
12,1,2,0,3,6,1909345.89976498,5348813.76905094
12,2,0,0,3,5,1254686.16306338,3040585.00567565
39,5,1,1,0,7,1880505.91283858,7896210.60387998
12,2,1,0,7,10,1976322.10123636,3963204.90860262
36,2,0,1,7,10,1759951.38653617,4482663.29923827
22,1,1,2,1,5,2285833.5441759,3328680.73887791
26,0,2,2,1,5,1456441.29909353,5520828.97988611
19,4,3,2,7,16,2312684.2142167003,6693848.3116791
37,0,2,2,1,5,1456183.70104322,2483648.31549983
11,4,1,2,5,12,1883776.33981426,7264206.69129897
35,6,0,0,0,6,1789722.26723583,5362935.0010494
15,2,1,1,1,5,1816356.43081212,5466667.98070269
23,1,2,1,2,6,1438092.31974756,5119574.87311463
35,6,0,1,4,11,2312674.68240166,6882033.61435586
27,4,0,0,6,10,1964546.53437896,5604702.02087658
37,5,3,1,0,9,1886728.2771472,3718210.7224065
29,1,3,2,1,7,1900705.76892362,6982799.37846763
38,6,0,2,1,9,1625148.65951152,7412268.14088961
10,1,2,2,3,8,1497078.12349701,4276507.32193632
16,2,1,0,4,7,1763959.24850755,6693876.60157112
21,5,3,1,6,15,2549501.89849516,9352729.29483536
29,5,1,2,6,14,2562313.37633581,6584557.83271637
18,0,0,0,3,3,1254738.25076616,4425492.23477117
39,1,3,2,1,7,1373021.53760871,4746773.76315594
38,5,1,2,7,15,2257884.53479866,9847504.86275977
31,5,3,0,4,12,1772337.64680391,7172511.84821013
21,1,3,0,7,11,2105334.15767478,8897682.18226033
18,6,0,2,6,14,2465598.34360558,2916694.37421733
20,2,3,1,1,7,1874173.17309991,5287050.81376861
24,4,3,1,2,10,1745627.46517237,6237950.26614893
14,6,2,0,4,12,2791249.4081709,5754218.24228006
17,2,2,1,7,12,2483257.60963113,8884252.152036501
36,2,3,1,6,12,2972391.86689885,5615885.48403083
10,4,1,0,5,10,2106993.73212427,8250801.44018861
27,1,2,2,6,11,2482802.96755255,6225992.36059871
10,4,2,1,3,10,2271166.05259471,7398261.11708266
39,3,1,2,3,9,1561823.7255719,4460514.24620917
14,3,3,2,1,9,1717645.14638251,6774078.54630872
27,5,1,2,6,14,2621782.70085264,8323260.7166928
27,0,2,2,2,6,1381628.14820321,8099930.93349
29,1,2,0,0,3,1371523.11607159,2892740.11759306
13,1,0,2,0,3,1741051.99598702,1741051.99598702
26,5,2,1,4,12,2256448.88291695,7776439.18912782
10,3,1,2,2,8,1816528.02652541,5000336.17092308
16,0,3,1,5,9,1726943.06253833,6249011.97822723
37,3,2,0,3,8,1590402.48439034,5437783.1608866
30,2,1,1,5,9,2424442.18314545,5870334.16592275
40,2,0,2,2,6,1633677.67077769,5122691.54911683
23,5,0,0,0,5,1427806.99036564,2441333.37140854
40,5,1,1,2,9,1703339.47315483,3340609.17576806
18,1,0,2,7,10,2061825.3065736,4993668.04965057
33,2,2,0,5,9,1314269.19377559,5699968.35194714
40,2,0,1,6,9,2307805.50538579,9154240.08068139
11,6,1,1,7,15,2323269.44535351,11181578.107087402
24,1,2,1,3,7,1736156.54340147,5899638.00392937
37,0,3,1,1,5,1316498.40748516,7608073.06867669
18,0,0,0,3,3,1292240.54148103,2401322.43761583
26,4,2,2,2,10,2681313.29227859,7086347.47648893
14,3,3,0,2,8,1903180.38391169,7125333.31099979
15,3,0,2,7,12,1827106.47136254,4996231.88618049
32,2,3,2,5,12,2703615.78739573,4685991.88054363
24,1,1,1,2,5,1457484.83470151,2866718.02132815
16,5,1,2,1,9,1855961.57662459,7347636.59934661
35,4,1,0,3,8,1943364.63664214,6115755.81120208
30,3,2,0,1,6,1288152.79020363,2194789.65373577
27,0,0,2,2,4,1488718.44727297,3260973.12698145
20,5,2,2,3,12,2747264.72136198,8552484.43139361
35,3,2,0,3,8,1943885.5453146999,5848304.36494019
29,1,2,0,4,7,1575085.13566347,6052094.53017892
13,6,2,2,4,14,1844486.10978042,8114095.17128569
36,3,3,2,7,15,2570467.68055473,9658334.79598003
11,6,1,0,6,13,2068024.15240168,7016502.75866623
17,5,3,2,0,10,2350574.66160945,6559514.28220323
26,3,2,0,6,11,2120647.20700969,7657048.32906896
32,6,0,1,4,11,2003513.50039879,6074766.70106224
31,5,3,2,6,16,3488679.66421451,9702160.38153412
40,4,2,2,1,9,1597539.0786446,3104937.63647603
26,3,2,1,6,12,2467539.2804003,7216524.15670066
27,3,2,0,3,8,1774755.65939483,7504151.09890199
31,4,3,0,7,14,2123317.26543374,6746749.29496951
36,4,3,1,1,9,1791195.39900364,4513177.37864695
11,4,3,0,5,12,2475685.01519718,7226547.14546551
38,5,3,1,3,12,1927819.80497846,7937461.17253402
39,3,3,1,3,10,1859202.99095358,5074892.83919674
27,5,3,0,0,8,1582548.95125023,5280015.76466687
31,0,2,2,6,10,2050538.33515964,8317533.42688812
17,4,3,0,6,13,1843742.68270823,10534766.1359885
33,2,3,2,2,9,2076410.8833585,9505411.60594706
28,5,1,2,0,8,1690642.89505607,4873507.35825759
13,3,1,0,4,8,1656277.22422997,7499740.82616313
27,4,2,1,4,11,1949160.79967747,4219528.04466876
10,6,0,1,2,9,1346210.03040793,5016339.41768267
14,6,3,1,0,10,1836684.8568343003,8520638.53564495
27,1,1,0,0,2,1180564.27832392,4214904.57584423
19,2,3,2,2,9,1864307.80863019,6135311.38535781
23,3,1,2,5,11,1821601.8056695,5870043.17658113
12,4,1,2,6,13,2509991.57992953,5158625.25347739
25,1,3,1,1,6,2162631.48885705,8663273.56672109
19,0,2,0,7,9,2027153.49306706,7244488.2549358
30,4,0,2,6,12,1664423.0263435,1895293.92879761
27,2,0,0,4,6,1264573.60367772,5419596.20950659
13,4,3,1,4,12,2032953.19963986,6928768.29189855
14,3,1,2,0,6,1452292.39128025,3106266.11115956
38,1,0,1,1,3,1706326.25806225,3290658.77032621
27,2,1,1,5,9,2183444.90244818,3046794.50770314
10,2,3,2,3,10,2265549.25597873,3812831.54741681
39,1,0,0,4,5,1500513.19086091,773562.956884335
38,2,0,1,3,6,1491851.25310828,3299784.81506495
18,6,0,0,6,12,2835711.22011694,7334103.58996467
21,5,3,1,1,10,1966979.28730641,7503270.52324928
40,5,3,0,3,11,1961322.28500465,6900593.50155849
11,2,0,0,2,4,1681011.02478391,6822052.37363185
35,3,3,0,6,12,1739107.90056207,10111174.3472975
32,2,3,0,5,10,2183608.83634732,6614947.03867725
24,0,1,1,2,4,1608443.96658752,803836.007229051
10,4,1,1,3,9,1962997.51688894,6642290.38370914
32,3,1,1,7,12,1826325.47590582,3433640.75931279
36,3,0,2,2,7,827034.408807863,5945164.06102828
23,6,1,0,1,8,1506888.95598942,3700878.66500736
16,5,0,1,2,8,1850700.43232155,6059931.87141653
11,5,0,2,1,8,1487132.27271064,5030052.22257347
13,2,1,1,6,10,2003904.1195913998,8349799.09219621
16,1,1,2,7,11,2590224.44906881,5646248.79912065
11,3,0,1,6,10,2101432.66275042,5050676.7600793
10,6,2,0,0,8,1501169.92933856,4169094.63633666
19,4,1,2,1,8,1486302.25032791,7957094.66621525
12,6,3,0,4,13,1956572.42308296,7653550.26980825
13,3,3,1,7,14,2507036.97036844,9886640.7860181
15,6,0,1,0,7,1639104.27678861,4816319.78467055
35,4,1,1,2,8,1663026.09898352,5966263.56224672
29,5,0,0,0,5,1282523.41558255,4270855.96063671
29,4,1,2,2,9,1954137.89860488,4489440.90043526
28,1,0,1,5,7,1442581.24067483,7262358.35516683
23,0,3,2,6,11,2542367.98807153,5804233.66621311
22,6,2,0,4,12,1797750.17140972,6260597.94982447
12,4,1,1,4,10,1695893.86444682,3093088.16712813
11,0,2,1,5,8,2366371.05449902,5782058.52130665
39,2,3,0,7,12,2616465.59626058,7856216.85999316
32,5,3,2,7,17,2398819.79319104,9303431.03386058
25,6,2,1,6,15,2436160.49124768,8070021.74060165
28,3,1,1,4,9,1655905.35465435,5294002.89197625
40,0,1,1,6,8,1994169.41724946,4695893.72254333
25,0,3,2,4,9,2051156.49099972,6899591.73430063
18,1,2,0,2,5,1072861.84726405,5100521.4549125
37,5,3,2,3,13,2238356.53761489,10035361.4149734
39,6,2,2,6,16,2787939.76240202,9827670.32414524
22,3,0,1,4,8,1379579.42716145,5908174.34318247
27,4,0,2,1,7,2022500.35934985,7550819.78236485
36,5,2,0,5,12,2467324.26462303,8372906.71673914
34,1,1,2,4,8,1787586.64988592,4555306.08853869
29,5,1,2,5,13,2127361.32386459,9333010.59565623
16,2,2,1,7,12,2432098.56956454,6776641.4790952
15,6,3,1,4,14,2350680.18201549,9804082.13799496
19,0,1,1,4,6,1485766.62045288,3283885.13523552
10,4,3,2,1,10,2059767.8134915,6397598.55803911
39,0,3,0,1,4,1317507.6261791,4309248.46708322
33,5,1,0,3,9,1637969.08607134,2906433.54734514
14,5,1,0,6,12,2166325.29893399,7615160.22419459
37,0,1,2,6,9,1897910.66103823,7394249.29602169
10,3,0,1,0,4,1566090.4346667,5240683.57253371
22,1,0,2,6,9,2033176.34830766,4720758.35903222
17,4,3,2,0,9,1791739.9875503997,5772827.09844393
25,4,2,1,5,12,2424235.12307784,8293999.51947443
33,2,0,2,7,11,2452059.48243871,4366872.73934977
11,5,1,2,3,11,2717864.90949181,4083406.48610288
17,4,2,1,2,9,2456932.64544705,6327361.19045942
22,1,1,2,5,9,1900716.51910789,6871503.91477538
11,3,1,1,4,9,2033387.06154158,6531421.58135669
19,2,2,2,4,10,2107281.88516768,8242107.83238299
23,1,1,0,4,6,1843986.31568956,4549129.67523233
21,1,2,0,2,5,1378671.38144144,3793348.44670938
20,5,3,0,2,10,1694242.67588214,7671364.41386818
40,4,0,0,3,7,1199641.38469145,4874931.95357935
21,3,3,1,5,12,2014075.51430599,8708335.92958736
13,4,2,1,3,10,2086453.73730739,7547409.49906238
40,5,1,2,3,11,2305978.36600893,5465331.49177689
33,3,1,1,0,5,1578300.82447192,2887232.10483465
31,4,3,2,6,15,3039954.83689765,8982156.81467093
21,6,0,1,5,12,2413504.91766537,5471848.34031563
10,4,0,1,7,12,1702851.61254914,6001212.50200744
23,1,2,1,4,8,1154131.597251,5493203.37638159
28,5,2,1,7,15,2123210.48350511,6049760.34998232
29,0,1,1,5,7,1581544.78941178,5496848.85779314
18,2,3,1,3,9,1537484.90408028,4559220.281890099
19,5,3,1,2,11,2042027.1082203998,6357643.80042867
38,6,2,0,5,13,2869800.35440701,3551456.25581375
14,3,1,2,3,9,1296488.50828505,3962465.70165932
17,0,3,2,5,10,2055692.3328133998,6673459.01875266
30,3,0,2,5,10,2021228.37698192,6660741.68953019
28,3,0,2,3,8,1647455.08326232,5042957.557572
14,3,2,2,5,12,2932030.20825283,5460740.70170853
32,1,2,1,6,10,2285545.66441762,2523439.15442262
36,5,0,2,6,13,2124056.35212262,5522401.30099541
31,1,0,0,5,6,1617316.44259287,2047384.94871145
33,5,1,1,1,8,1714417.80328792,6349608.67860967
20,4,3,2,1,10,1783547.52443308,6987466.09316282
25,0,3,0,5,8,2001368.19583779,5527829.21467539
12,2,2,2,1,7,2126273.31904408,4792410.73606847
27,1,0,0,7,8,2363046.03956062,5443461.76044667
21,1,2,0,5,8,1735250.69748952,6338668.47110084
13,3,1,2,3,9,1546519.62032748,7789681.14679299
34,0,2,0,6,8,2177839.34629992,4946268.79838204
18,1,0,0,2,3,1048781.5310589,4741771.24280511
37,5,0,1,3,9,2154884.36354527,4787146.42810978
22,3,1,0,1,5,1464268.34943387,3989334.77881217
27,0,3,0,0,3,1161680.85531541,3716237.35127049
16,2,1,0,5,8,2164837.36757934,7729010.28762376
35,4,1,0,7,12,2452503.84550857,7988792.09422349
29,3,1,2,1,7,2092893.91840681,6154283.87046313
29,2,0,0,7,9,2041542.69294371,2292775.1399707994
16,3,0,1,4,8,1815153.10548798,4949023.85681254
32,3,1,2,1,7,2060214.95561908,5550575.63478799
20,1,0,0,4,5,1412646.00889115,5828097.99996908
27,1,0,0,1,2,1329160.70090507,3235211.20186075
15,4,0,0,4,8,1748608.5164450002,2381427.30313968
35,4,1,1,1,7,1158215.34300956,6005218.147954
21,6,3,2,5,16,2496704.19317362,9098994.80989772
30,2,1,2,5,10,1978861.81364889,6608947.45649453
10,0,0,2,1,3,1198919.88546598,1420827.9612846
37,3,0,0,3,6,1734823.42807454,4939624.63830283
40,1,1,2,2,6,1671858.5290132,5420137.81933463
39,6,0,1,0,7,2146031.37373642,5480243.50261832
36,5,2,0,5,12,2491524.62371899,2224119.21098577
26,2,2,1,5,10,1874310.6826884998,4700130.37045944
11,3,1,0,5,9,1641099.13841965,6039381.12152598
22,4,0,0,2,6,1989341.47681591,6309108.10287731
10,5,2,1,6,14,1987216.27116878,5662835.44360039
25,0,2,1,6,9,1706415.25054397,6883044.32932864
29,4,3,2,5,14,2342658.72020441,5192556.53594837
27,5,1,0,5,11,2334742.45005344,6878368.15183589
16,1,3,1,5,10,2590560.26699302,5214451.927330799
37,4,1,2,2,9,2446859.43676935,6777269.33443847
22,6,3,2,6,17,2379440.60136619,7551782.78535275
15,2,3,1,4,10,1646828.84875844,4496882.766848099
16,0,0,1,6,7,1602615.09700563,2136842.4177435003
21,5,1,1,2,9,1989075.81664987,8263801.15696036
33,0,0,0,5,5,1499210.19391878,2358438.66150365
25,6,2,0,2,10,1441501.9111456,10032878.2125693
20,5,1,2,6,14,2500174.23275314,7454366.21785384
16,0,2,2,3,7,1874201.27149161,4076918.62133012
28,5,0,1,6,12,2171319.85727998,8641767.17928999
21,0,2,1,3,6,1519807.67782805,3493373.60253042
15,4,0,2,6,12,1790188.64488097,6649426.73101421
36,2,2,2,1,7,1611237.85787209,5680178.14096004
22,2,3,0,2,7,1422126.88305226,6427722.82864247
11,2,3,1,3,9,1640560.31885926,3609336.88730863
30,3,0,2,3,8,1941260.63943191,4851302.62821875
24,5,1,2,0,8,2004407.31229303,4067836.16220275
36,2,3,2,6,13,1997461.18587698,7320613.92044292
32,4,1,0,7,12,2068558.14842784,10307191.7071696
15,0,0,1,1,2,1279094.01789417,4108200.36328597
16,5,0,1,1,7,2530760.1126402,5920480.67287527
21,4,3,1,5,13,1796140.05057588,7501725.111063001
27,1,2,2,1,6,1542695.75700139,5510511.857569001
26,1,2,1,6,10,2102993.93058891,2923356.57747295
17,3,1,0,1,5,1139488.61852856,6322961.51810216
29,0,2,2,2,6,1284304.44813857,2882812.96014786
33,5,3,2,3,13,2833610.08272189,9810170.64568252
38,3,2,2,5,12,3012902.30589251,7360427.57359941
11,5,1,1,0,7,1434837.90513354,4230951.20341375
22,1,2,2,6,11,1910394.80573109,7928136.20324596
13,5,2,0,2,9,1835649.72082846,6427551.63669181
14,3,0,0,2,5,1398406.89523584,3689852.9124144996
38,4,2,1,3,10,2474267.17581523,6496504.532542201
11,6,1,1,7,15,2095006.45278657,2102914.48721289
31,1,1,2,0,4,1154528.74690857,3966377.7586018997
16,6,0,1,0,7,2123955.90615405,6946684.88371295
18,1,0,2,4,7,1362364.3003765,7117811.14040024
13,3,0,1,0,4,1221326.42675751,3890525.88176652
13,4,3,2,7,16,1993134.9792882,6766716.44280924
39,3,2,0,2,7,1938504.21590243,6219096.16444992
16,0,3,1,6,10,1879704.78012781,9671333.28457246
19,6,2,0,1,9,2046329.45212462,6627546.32456949
36,3,1,0,5,9,1802093.5896803,4597581.23752393
27,4,0,0,2,6,1045213.20029067,4091634.04611376
22,5,0,2,5,12,1814746.70269299,3747066.13832838
22,3,2,2,5,12,2118398.29204035,7942599.2527228
10,4,1,0,3,8,1359433.94735194,6034919.72753138
15,3,2,1,6,12,1594036.16370999,5809685.74958024
39,6,0,1,5,12,1879300.70583486,9984740.03976207
25,5,1,1,3,10,1861401.27545434,6184666.65050637
40,1,2,1,4,8,1680899.28480624,5847064.33098499
14,1,2,2,3,8,2313253.69682713,4514790.61101378
24,1,1,0,1,3,1332278.88668836,3908519.86595703
34,6,2,2,5,15,2526393.67035372,4382646.60688947
11,2,2,2,2,8,1843450.99178998,6402485.25299618
12,5,0,0,2,7,1518895.09882768,9571283.93433955
26,2,1,1,6,10,1928038.64097204,9155874.62500891
17,3,0,1,0,4,1405010.17157259,2696418.70182711
25,3,1,2,5,11,1516172.38644963,5511549.34862874
11,4,2,0,1,7,1616740.81428832,5432595.28793729
33,6,0,1,3,10,1534131.10566971,7102846.4336419
40,4,1,0,6,11,2049169.65002144,8155767.43466188
38,1,3,1,7,12,2892697.44749259,5159481.3354683
33,6,3,0,3,12,1903587.59640146,8448857.84698961
21,3,2,1,0,6,1708282.14411915,7351324.11766388
30,6,2,1,0,9,1748924.86002307,5299592.81753568
18,6,2,0,0,8,1871187.34952055,6156401.94454649
23,4,2,2,1,9,2152545.09627184,2423361.36061115
35,2,2,0,5,9,1610559.48708166,5555642.95960691
15,1,2,0,1,4,1348146.03106588,1845929.7699953998
27,4,2,2,0,8,1708225.86407771,5220884.77249019
12,3,2,1,3,9,1814994.23190605,5138668.16147398
35,1,2,1,1,5,1606304.73574895,4755602.66749932
17,2,3,2,3,10,1801848.91314442,4047053.48957763
20,5,2,1,4,12,1787626.96623188,7747170.71647969
22,2,0,0,3,5,1837603.33347658,3833245.44758327
15,5,3,2,2,12,2005984.20965293,7514730.56077168
18,2,1,2,5,10,2274377.09109506,7200601.94847387
31,0,1,0,7,8,1780970.42363982,4328543.24396227
13,4,0,0,6,10,2068369.74771915,4117273.72804674
22,4,3,2,3,12,2089975.74562681,4208153.05165624
23,3,3,1,6,13,1880161.26441158,6410187.84744682
10,0,0,0,1,1,1136632.03743224,3012672.50013277
10,4,1,1,2,8,1412696.27256834,6197280.0354005
24,1,2,0,2,5,1288993.96546112,5698424.35726755
32,3,3,1,0,7,1548710.08037294,3791973.17112889
34,2,3,1,5,11,2251097.28515212,8162291.61180413
15,2,3,2,6,13,2605997.76937368,6371098.67447757
23,3,1,2,3,9,2017899.29524126,3100309.01861011
11,3,2,0,5,10,1487706.27397439,6301987.99427784
34,0,1,2,1,4,1261797.58545154,4387971.97095898
34,5,1,0,4,10,2466496.70790178,9056897.63714113
30,2,0,2,4,8,1393366.57828432,5229065.52555932
13,3,0,1,0,4,1460633.40147151,5176548.12780847
23,2,3,0,7,12,2263547.09047776,2615734.84849377
12,0,3,1,3,7,1755362.83913107,2055259.39500422
27,3,2,2,7,14,2132966.83345274,9675266.05007342
38,0,1,2,5,8,1795384.26646196,5549539.62986717
15,5,0,1,2,8,1856961.06144664,3359035.13820038
15,1,3,0,0,4,1398257.80983191,6945442.26318857
37,6,2,2,6,16,2464582.20023277,5756465.46434065
39,1,2,1,5,9,1942272.19450161,5800182.08622534
37,5,1,2,3,11,2685361.85538663,7760109.91184003
15,0,2,0,5,7,1746812.94845109,4427293.15343683
39,1,0,0,3,4,1775089.75295496,4526771.67934554
29,2,0,1,1,4,1490845.85010779,4735600.83776308
13,1,0,1,3,5,1400408.25057557,4050617.99589384
27,6,3,2,0,11,2175192.80059444,9875511.31434451
30,3,3,1,1,8,1764982.70873302,5741216.87284814
16,5,1,1,4,11,2681114.16934433,2912497.03458126
33,6,3,1,7,17,2880160.0685729,8260885.56557025
10,3,0,0,7,10,2202562.68319941,7595117.5990819
20,5,1,2,6,14,2769945.73736065,14590516.0024302
21,1,3,0,3,7,1652803.97945508,3138701.00545633
26,5,0,2,5,12,2765805.51289398,7639525.42777127
33,2,1,0,1,4,1280801.78175609,5242884.11959076
29,0,3,2,4,9,1865057.0534130002,6204483.3969920995
11,5,1,1,2,9,1333770.98914884,6510091.92477318
20,3,3,2,0,8,1743919.39077937,5469963.97900361
36,6,1,0,0,7,1511884.43060767,5389929.82308846
30,6,0,1,3,10,1716002.62768387,4797965.538757499
22,6,0,2,0,8,2343961.87259949,3397552.76339391
21,1,3,0,6,10,1572970.7533369,2969257.62237193
40,6,3,2,1,12,2571712.8317885,9722143.71523578
39,0,1,2,6,9,1792365.11692922,4973961.18294036
15,4,3,1,1,9,1893177.80400809,5195022.54381974
40,6,2,2,1,11,2029000.49089777,7502891.22672932
33,6,2,1,7,16,2845466.99223948,9187104.317327801
24,3,0,2,3,8,1888099.67805212,5982382.14797227
29,0,0,2,2,4,1100321.74444412,3634249.68367224
31,4,3,0,0,7,1476882.69160575,916949.577880102
13,4,3,2,0,9,2328552.76293321,5677004.79819384
39,3,0,1,4,8,1760952.02029853,3439534.79693447
35,4,2,2,3,11,2128721.18000455,5894239.38322656
24,2,0,1,4,7,1950297.95164456,4494730.00115241
25,3,0,0,2,5,1586895.47724078,6762965.41782319
23,4,1,0,2,7,1621104.54170135,5915489.06015711
34,5,0,1,3,9,1817475.04506441,5232227.26903339
24,4,3,0,0,7,1704529.8482513,5504194.653730201
36,2,2,0,6,10,1394825.76759,8693167.32636001
19,6,2,2,0,10,1424285.50687178,7948707.79659056
11,6,2,2,6,16,3015910.35449066,7925484.59729546
12,0,3,2,7,12,2474357.76379456,4969770.37593336
38,3,2,2,6,13,2670046.84024914,4205983.87665281
25,0,0,1,1,2,1008630.0790443001,268481.798839232
25,2,1,0,0,3,987630.171908743,2144217.4243475
30,5,2,1,4,12,2213606.04096893,6598878.61214462
13,0,3,2,0,5,1453719.72170076,5238395.8894598
20,1,0,2,7,10,1524826.80504597,5149963.19119162
14,1,1,1,2,5,1364004.92871777,5500577.79277232
13,1,0,0,7,8,1208894.41472611,5387285.3511935
23,3,0,2,0,5,1753745.68428566,5556730.37501609
23,2,2,1,1,6,1487290.86096824,3894864.6017016
28,2,0,1,1,4,1331637.50816679,3256744.74333379
32,3,2,2,7,14,2498313.23981072,6710796.72790942
13,6,1,1,5,13,2348578.0223172,7260201.22448568
39,0,3,0,7,10,2031047.68253064,6950051.7160205
25,4,3,2,5,14,3319537.05565109,6023513.93897601
19,0,0,1,7,8,2518505.17150911,6045336.85534005
38,4,2,2,1,9,1999499.25285831,1313987.62741649
24,2,1,2,4,9,1843160.18509091,7836845.64146711
26,4,2,0,4,10,1941689.72911819,6841600.72823362
38,0,1,1,6,8,2131824.91674508,3945767.04565735
10,5,1,2,3,11,2096994.77450284,4383540.65535296
12,1,3,0,5,9,2016693.61205568,4880999.42457404
27,4,0,0,7,11,1924210.0020538003,7703251.67996647
18,4,0,0,1,5,1907886.95678793,2543970.04690438
19,2,2,0,1,5,1962792.66492662,4649238.79972293
36,3,3,0,1,7,1397227.86869226,8465427.85216308
19,3,2,0,2,7,1345441.71014731,4249570.42943686
40,5,3,0,2,10,2214529.04663195,4350215.07580847
17,1,1,2,7,11,1863692.29590515,5546752.73969576
28,0,0,1,6,7,2113651.30338065,3386286.19992572
20,6,3,2,2,13,2264520.55575233,5154681.38410434
11,1,1,0,7,9,1928713.71759546,5383749.04679074
19,2,3,2,1,8,1521804.63467877,6495790.73292831
27,3,1,0,4,8,2149736.22885818,4720441.32065326
24,6,1,0,6,13,2208357.32690288,8449645.84990852
27,3,3,1,4,11,2082592.66444879,5629475.2027177
39,3,2,2,2,9,1695132.85479755,8351044.63761736
25,1,2,0,3,6,1428472.23068732,4919793.96642422
38,3,1,2,5,11,2589312.21678597,3320864.6378913997
28,2,2,1,4,9,1958743.13418188,5935120.65861838
11,4,2,0,7,13,2726982.460846,8255096.65066945
20,5,2,2,4,13,2927652.46211923,5148841.84482759
15,0,2,0,3,5,1559702.58919979,900654.432279425
37,1,2,0,1,4,1519472.74814879,7965999.91930704
17,0,3,2,1,6,1115148.06003162,5059135.20149277
23,0,1,1,4,6,1239729.55197308,4350340.09433703
12,5,0,0,1,6,1691445.03752073,2907582.30946715
29,5,3,1,2,11,1739171.82554488,5491904.48279625
36,6,2,2,2,12,2447556.13330817,8084697.12864072
20,5,0,1,3,9,2403221.87347004,2690841.4909544997
11,2,0,1,1,4,1425329.24930492,5165361.78452322
12,1,2,2,1,6,2014272.08044582,3950985.80864835
35,2,1,1,0,4,1582252.79290119,4112758.63051378
21,1,1,0,3,5,1212411.39329754,3835456.68135283
16,1,3,2,5,11,1616738.91606961,7431350.2563595995
29,0,2,1,1,4,1389033.39977513,2124767.76344261
36,3,3,0,7,13,1687999.65126324,8208897.33803256
21,6,1,2,7,16,2713195.9661651,9159999.30652118
10,5,2,2,2,11,2387791.21181292,8076505.26383392
29,6,2,1,2,11,2389209.16517048,5476471.30690746
16,2,3,2,6,13,2371562.2198851,3523188.14345151
28,4,3,2,5,14,1979506.74779711,7361440.55615922
14,0,2,2,4,8,1586812.48564271,6530831.55341388
28,1,2,0,0,3,1168008.01188676,3888156.07665676
25,3,0,0,6,9,1942154.65700294,5365561.36771557
25,5,3,2,5,15,2198631.42547634,7727640.29559418
20,4,0,2,7,13,2248669.04171114,7250642.08717861
17,3,1,2,1,7,1442922.5184341,7040747.32571943
12,3,1,1,2,7,1713120.10475547,5792037.63526943
17,4,1,1,6,12,2850254.46685249,1486365.28931154
24,1,2,0,5,8,1172709.54636143,6887558.29617869
28,1,0,2,6,9,1915429.48004043,8685652.74402536
28,1,2,2,4,9,1177023.9419781,4673338.6451148
33,1,1,2,6,10,1679888.53543873,222138.81604758
20,2,0,0,4,6,1622412.66483939,4680486.68927997
35,4,2,2,4,12,2476164.74826515,7077311.54879809
13,3,0,0,0,3,1368050.37080141,1439304.32305374
21,4,3,0,3,10,1808174.14267072,8145796.86102135
17,6,3,1,4,14,2552832.16271425,3937567.89780069
36,6,1,2,4,13,2690234.53184461,6624027.136811799
25,4,0,0,3,7,1447808.9864921998,5384128.42533663
40,5,3,0,1,9,1979046.30868031,7070386.12190337
10,3,0,2,1,6,1190304.23205217,4347986.83947072
18,3,2,0,5,10,2139318.06105227,6946370.94374374
18,2,3,1,4,10,1895247.82329854,5990269.11647658
13,6,0,0,2,8,1606663.08410106,4882035.10131447
37,1,3,1,7,12,2095608.28330234,6009370.51421446
28,2,1,1,3,7,1661997.58669837,5126889.66602321
12,0,0,2,4,6,2035163.06505454,4899309.15099001
35,4,2,1,4,11,2169296.69718723,6532373.14050821
37,4,2,0,2,8,1577632.00814315,3266223.21711898
32,4,0,1,6,11,1967067.96412553,6640512.40061579
27,2,0,1,1,4,1550972.05221105,6554166.79544789
11,0,2,1,4,7,1588032.38855684,4883730.54211861
38,0,1,1,3,5,1348917.78011544,4741927.10739459
34,4,1,2,7,14,2443051.04459121,5366079.37886537
10,1,0,1,4,6,1384610.1823983,5390174.32986657
33,2,3,2,6,13,2335618.87240828,6924429.20523348
19,3,0,2,4,9,1888233.17186242,7179453.64968134
33,5,0,2,1,8,2211347.41157752,4915687.54525971
21,1,0,2,3,6,1811214.90926522,4478577.95328122
12,1,3,0,5,9,2297660.69269843,6498148.86362614
25,4,2,0,4,10,1914613.33837754,6856931.64990622
29,3,1,1,6,11,2067152.46898136,5892384.29887353
30,0,3,2,4,9,2036686.85720105,9514897.32572309
19,2,1,1,4,8,1893152.8376378997,5377439.00557516
24,5,1,0,0,6,1977088.07323286,6280617.0578616
40,1,3,0,4,8,1380164.15772652,4899067.4980096
17,3,0,0,6,9,2279273.09784091,3266136.35314312
13,5,2,1,4,12,1383200.89201183,7794836.95436187
18,4,1,0,4,9,1506932.40625688,6631886.66284999
18,3,3,0,3,9,1967282.75772165,5898411.69429313
37,6,0,2,6,14,2675329.30201355,6398084.93304128
25,3,1,0,4,8,1655498.95967551,4317001.05795679
11,6,3,2,2,13,1671685.69977517,4661543.73128469
20,1,2,2,6,11,1759447.93912933,5977878.88963251
27,0,2,2,5,9,1950051.51112239,8145303.67002632
11,2,0,0,6,8,1321001.81866578,4953533.93194098
32,2,3,2,0,7,1708305.80991143,6133807.85047552
22,2,0,0,2,4,1535712.22121557,4215801.02405431
30,6,2,0,1,9,1683872.89959163,3109815.67605897
37,0,3,1,6,10,2159707.13987042,4716612.29663637
18,3,1,1,7,12,1924292.07904144,6569035.84962595
33,6,2,1,3,12,2209424.73054768,6901727.54692824
30,4,3,0,2,9,2009320.94004661,6451695.23413047
32,1,1,2,5,9,1906889.85361452,5494249.10210439
38,1,2,0,3,6,1918282.51723737,5424720.561258401
34,3,1,2,7,13,1844020.18992908,4650234.42572455
36,0,2,0,0,2,1311213.95925936,3911978.66326704
11,4,0,2,6,12,2670172.24889946,6834877.27005498
14,6,0,1,6,13,2272461.35242399,5020657.583007701
14,2,0,1,7,10,1984249.92188734,5368070.45709704
11,0,2,2,4,8,1731664.74062972,5067152.64351933
11,0,1,0,1,2,874897.9847946779,2381946.19564059
11,1,2,0,2,5,1292078.11563434,2731160.20103395
20,6,1,0,6,13,2400763.29990166,7955545.78730708
33,2,1,1,3,7,1548940.27489478,3927770.86759962
34,5,1,1,0,7,1984983.06210633,5688731.71397775
11,0,3,0,5,8,1984237.24768416,4165276.23383426
20,5,0,0,3,8,2121484.65282838,4438765.09804131
34,4,0,0,5,9,1869550.76979842,4690559.60907387
24,0,2,2,4,8,1757625.25304755,5251885.93342846
23,1,1,0,1,3,1398934.53650355,5435581.72705506
38,1,3,2,3,9,1895918.76996794,6292914.09626453
39,6,0,2,2,10,2082277.95342432,2905291.09912478
24,3,0,2,3,8,1630449.201315,5159982.80810885
11,3,2,2,0,7,1833419.51490519,4482537.02146961
22,4,1,0,0,5,1352928.66599213,4495986.89015246
18,5,2,1,2,10,1905835.21594431,5369885.22494461
27,2,1,1,0,4,1406412.27125933,2188027.86017673
34,4,2,1,5,12,2753318.08323848,5933257.23854123
12,2,1,0,6,9,1693427.50499504,4438165.41846951
20,0,1,2,2,5,1690772.90740884,4966317.7999978
40,1,0,1,6,8,1900385.63365926,5101479.36631896
30,1,3,2,2,8,1817006.38299683,4834673.07054865
37,1,3,2,1,7,2055759.5018496998,3440509.03363278
20,0,3,1,3,7,1388258.68672795,4053739.60903734
38,0,3,0,3,6,1693824.22844294,3678036.29044843
20,3,2,2,7,14,2024949.04588171,8279223.82866903
15,0,1,2,6,9,1396692.93332562,5623720.98535686
26,2,3,2,7,14,2070175.7034827,5462694.87571489
37,1,2,0,2,5,1676498.00460019,6207486.57200768
15,3,1,0,6,10,1983226.52132945,4040305.20075382
10,3,0,0,3,6,1619751.84601705,1891890.85222892
28,2,3,2,7,14,2249344.74404329,2751482.41392744
16,2,3,1,0,6,1825818.7764273998,1556306.83707773
32,3,2,1,6,12,2157037.52490217,6492571.58637861
28,1,3,2,1,7,1414712.96874889,6376468.37152172
24,0,2,1,2,5,1559403.18522973,3963509.30805475
21,4,1,1,6,12,1870141.79845652,7177363.45245819
16,2,2,2,6,12,2015249.48216183,5294933.26117116
39,1,0,1,2,4,1093014.90042797,5160751.56163835
33,3,0,2,7,12,2613678.24492458,5131010.39414067
21,5,0,1,5,11,2717004.68986573,3180245.86232808
18,2,1,0,5,8,2261585.23206809,4552606.01725257
34,4,0,1,0,5,1667099.83554912,2719895.21293509
37,6,2,1,3,12,2884362.3201666,9141446.26672222
15,2,2,0,4,8,1756932.33452981,2976024.04611978
10,2,2,2,7,13,3088914.06911839,7406750.54541543
10,6,0,1,5,12,1652175.34713266,5243415.4376428
13,4,1,1,5,11,2640596.91852531,4724204.19794364
34,2,1,1,7,11,2101753.23941634,3440592.17797381
14,1,0,0,7,8,1873749.1596189,6565968.3709203
37,1,3,0,1,5,1210975.95573901,6514812.76115243
19,6,3,0,6,15,2437858.03673139,5185849.07552621
40,1,2,0,3,6,1629349.41335659,5365420.35336445
19,1,2,1,1,5,1901770.45620557,5042561.27993063
24,1,3,1,4,9,1984767.30892657,8779628.30427159
31,0,2,2,7,11,2622040.03917197,4138214.9443003996
23,6,3,2,2,13,2571132.80189497,10959114.064832902
32,1,1,2,3,7,2002660.33893397,3486879.24416257
33,6,3,0,6,15,3240084.81156819,10246321.5026885
19,3,2,2,7,14,2121244.78958351,6209594.84801338
40,6,3,0,1,10,2925699.73684485,3011411.62111396
27,0,2,1,4,7,1803429.56742746,6131511.15699629
22,0,3,2,6,11,2327560.21833265,6391221.05119277
40,4,0,0,1,5,1442399.39250689,3710403.66782981
11,1,1,1,1,4,2083790.2982818,5468358.52340331
22,3,3,1,6,13,3114009.36911413,6791868.71569812
16,2,0,1,3,6,1628499.26847851,6966241.81041116
21,1,2,0,2,5,1762078.41148492,5255105.73727446
17,0,0,2,5,7,2196516.24555268,5627533.44884468
27,6,2,0,4,12,2202341.6610695,1197569.1783187
35,1,3,2,1,7,1686779.70693854,5932917.39378222
34,4,0,0,4,8,1665337.6212866001,4862828.11612493
24,1,3,1,0,5,1306299.51898699,5969819.48633771
13,6,2,0,7,15,3544807.36493205,8535788.22072463
17,0,1,2,4,7,2012247.90016328,4950051.38883818
23,5,0,1,3,9,2295564.85288335,6506616.22530149
28,6,0,0,3,9,2295083.72042366,3280396.52632277
26,1,2,0,7,10,2123468.80939855,5727804.52183991
34,2,3,2,1,8,2046726.95542427,8662358.86149335
20,4,3,1,3,11,2366222.80977488,5847544.92271933
40,1,2,1,3,7,1572464.72489595,7880092.88091112
22,5,3,2,7,17,2806050.8021714003,7744344.41868314
22,4,2,1,3,10,1989364.87093642,3882431.06701179
18,1,0,0,0,1,1107943.43539801,1761971.73432506
15,2,1,0,3,6,2025707.06840158,4668958.86479111
25,0,0,0,1,1,917892.119436955,2849230.51853176
24,4,1,2,1,8,1717680.41368955,3857642.68123444
29,6,2,2,1,11,2325998.70337722,7765531.60590319
22,0,1,1,2,4,1055893.51419025,5085599.535350299
13,1,3,0,4,8,1301913.49881189,4871819.05112842
30,1,2,2,6,11,1904841.6218288003,7543336.79237192
24,6,0,1,1,8,1397822.14736299,6054975.77013037
36,3,1,2,3,9,1610797.80590043,3158020.47612362
32,0,3,1,0,4,1721500.55286804,4778594.92452857
26,1,2,1,2,6,1771136.56930735,3649837.55845848
33,3,3,0,0,6,1559520.34636526,5216073.09821102
21,1,3,2,6,12,2378969.29560339,7835205.39423507
30,0,1,1,5,7,1856781.15101556,5084672.09058382
38,6,0,0,4,10,1878174.61499982,7534120.32554423
34,0,1,2,4,7,2267461.85395535,4103540.90713888
18,6,0,2,5,13,2045410.10774376,6378999.74672392
31,3,0,0,3,6,1435925.95440184,3541526.4961798997
23,0,3,1,1,5,1490104.27743195,4103111.77633405
20,2,0,0,3,5,1722823.49818822,3711401.06536726
39,5,2,2,2,11,1987026.3812514,3462215.75895881
37,6,1,0,4,11,2162532.49127533,9442411.91734777
37,2,2,2,0,6,1143030.33402507,4104251.64566941
40,4,0,0,0,4,1486889.73019891,6565300.35898411
12,2,3,2,5,12,2537319.41756385,5694891.0419015
28,1,2,1,0,4,1295079.37098069,6875263.266470599
32,1,1,2,5,9,1984579.17335568,5632689.02649751
28,5,3,2,3,13,2769198.6603898997,6589889.30340888
12,4,0,1,2,7,1540471.43651202,3986786.89925225
40,3,3,2,5,13,2226368.35075256,10302557.836915899
33,5,1,2,7,15,2779789.01298559,10891102.991266802
20,6,0,2,3,11,2413742.70609702,6356773.09633234
31,6,2,2,1,11,2452173.15067693,5838415.89602036
12,5,0,2,2,9,2397202.2563654,8645869.62173641
36,3,0,0,2,5,1306147.04306831,5179248.52891241
23,3,0,2,3,8,1357383.01604338,889690.7370472541
26,3,3,0,3,9,1770076.48272293,7216708.11504023
21,6,3,1,0,10,2445355.95863726,4057935.87121016
27,6,1,1,4,12,2512113.67480524,7108508.95209227
36,1,1,1,5,8,1704900.87396035,3614909.76448607
22,0,1,0,1,2,1278954.70232462,3054335.60003863
20,0,2,0,7,9,1868188.62580282,4696128.90793595
20,5,3,0,2,10,1723859.63796222,7104675.16384262
32,6,2,0,6,14,2939677.94835512,3820533.56754294
23,0,3,2,7,12,1999898.52259777,7748403.08668287
31,0,2,0,0,2,1177702.58473789,3358204.80760827
37,4,3,1,1,9,1983994.81329611,2586395.35009322
23,5,2,1,6,14,2777070.20141893,8513533.82016964
34,4,1,0,1,6,1406150.79704809,5362520.43784006
11,4,3,2,0,9,2088678.13950309,6978330.29870093
32,6,3,1,2,12,1846658.01097969,8214147.67623623
15,1,2,1,5,9,1668964.08269099,6885876.2260399
37,6,3,2,1,12,1959715.89902402,6896436.291541499
27,0,0,1,6,7,1843530.93887941,4391984.13293037
17,1,0,1,0,2,1122948.8643643998,6051185.02372523
27,6,0,1,0,7,1997699.17064294,4094454.03528688
18,3,0,2,0,5,1159641.11443986,4887324.53328403
20,0,1,0,4,5,1627983.50697078,3466209.49803491
33,1,0,0,3,4,1351878.32716839,3178280.26761441
25,6,0,2,1,9,1890041.2080455,5641351.22909024
13,6,2,1,7,16,3423383.60956365,9318745.97928724
29,6,1,0,1,8,1611268.26463876,6997469.87356131
17,5,3,1,6,15,2522355.37778164,7682331.295546601
34,4,3,1,0,8,1673038.97494737,5657017.57451903
10,6,0,1,2,9,2005295.27121752,6608384.2383336
23,0,0,1,0,1,1091869.01980143,1303794.66145873
24,5,3,0,2,10,2195534.92285371,2332873.57416832
35,4,2,2,7,15,2767822.79201439,5385392.45797606
12,5,0,0,0,5,899534.9975885521,4612064.26919096
19,3,0,2,2,7,1904900.84210093,4206395.84536629
27,3,3,2,4,12,2280149.02320387,7416038.33352844
14,5,2,2,4,13,2163436.98695513,3947102.50037172
28,3,3,0,4,10,1984753.44471856,5616866.80073405
16,5,0,2,4,11,1475768.32324609,6364053.78780954
15,2,3,1,5,11,2356241.15030495,8151826.041812799
38,2,0,1,1,4,1213287.83276275,6131747.18608583
16,2,2,0,5,9,2419119.95876974,3203289.64393033
29,1,1,0,1,3,1552335.7251327,5014143.69709626
30,3,3,0,6,12,2319979.34640891,7611531.33651471
26,5,2,0,3,10,2213065.19442143,8887893.92152151
12,1,3,0,5,9,1779833.86715614,7998619.71566111
30,6,1,1,5,13,2353011.53461695,7556586.7813353
10,2,3,1,4,10,1656478.48734471,6510457.94028937
26,5,3,2,4,14,2757869.02433845,8604277.00607596
37,5,1,2,1,9,2257098.22918434,6538924.48329652
27,2,2,1,7,12,2077026.18937475,8089400.42935903
26,4,1,1,0,6,1676569.1114947,5043323.29656881
37,2,1,0,1,4,1443847.24914695,3189995.40606038
22,3,0,2,3,8,1966065.78860859,3981203.88579142
24,0,0,2,4,6,1792333.14046468,9174092.99913387
29,5,3,1,7,16,2380548.53294837,8603518.45389384
11,4,3,1,1,9,1432090.66046967,3221099.27690068
35,3,2,1,1,7,1643783.49477678,8740424.59916295
23,1,1,2,4,8,1816726.23361517,4664468.17257938
22,3,2,1,4,10,1985795.14811536,6677818.56289299
17,2,3,0,5,10,1929419.13871396,7421184.75039727
28,5,1,1,3,10,1735412.72738245,6229936.78561937
38,2,3,1,2,8,1779290.80860556,5113235.70351097
25,1,2,1,3,7,1906363.01043059,5790263.66548898
23,3,3,0,7,13,3620709.13116022,4940771.1883543
24,6,3,0,4,13,2422150.29529797,7427751.50641646
14,2,2,2,7,13,1880296.11510979,6806444.46846745
15,3,2,1,2,8,1952434.09583218,4856450.4694569
19,5,1,2,5,13,1799929.99484512,9591965.27752459
30,1,0,1,7,9,1834310.9487852,8259937.41765649
30,2,0,0,3,5,1473111.16249183,5853657.5178461
29,2,2,0,3,7,1746075.85598972,7451487.60962438
12,4,2,0,5,11,1470401.09175682,4999634.37618413
15,3,3,0,3,9,1499340.36215598,5483065.21229183
35,0,2,1,6,9,1929568.36483332,9086851.87932447
40,0,2,1,1,4,1153657.96093741,1203398.38468713
37,0,1,0,7,8,1495532.66877437,6199056.80599004
37,5,2,0,1,8,1958560.87667079,5659463.20567337
24,1,0,2,6,9,1865593.95309693,4067675.35073142
27,3,1,1,7,12,2311302.30417724,8499472.07026578
33,2,2,0,3,7,1871484.67309728,5436831.53127724
36,6,1,0,7,14,2092862.13761709,7902814.60856535
40,1,1,1,3,6,1534008.17340248,3939978.14622877
10,3,0,0,4,7,1324450.80649936,4434051.40740151
12,3,0,1,2,6,1552980.76076934,3806467.4102283
35,5,0,2,5,12,2562698.00472754,5472568.34254891
20,4,0,0,1,5,1137805.32468645,4484052.61189504
14,6,1,0,5,12,1211366.98820126,5877960.6098091
39,1,3,1,2,7,1308672.36602308,3272721.53069984
30,0,3,0,0,3,1254655.13732305,519165.094949819
13,4,3,2,2,11,1722274.85513261,6348599.8854985
10,2,3,0,6,11,1553567.16285467,8849150.24766014
12,3,1,2,2,8,1844276.61364249,7136253.63762496
40,6,3,2,0,11,2243942.55172921,8139551.94156756
25,5,3,1,6,15,3470104.92080419,7287842.49585792
32,5,0,0,2,7,1339131.80597249,4690490.21994555
22,3,3,1,2,9,2108179.66671661,7079801.64693288
16,4,3,2,2,11,1632550.77046461,3997042.55500549
30,1,1,1,7,10,1540563.15342918,11895062.3199099
12,5,1,0,0,6,1543003.04309546,5581470.57602321
18,5,0,0,0,5,1706022.19565198,3065087.59621251
18,6,1,0,4,11,2138967.54675768,6380231.14274167
13,5,0,1,3,9,1602271.7895128,6634058.66061178
26,3,0,1,5,9,1857683.75351985,3605301.12918869
24,1,0,0,6,7,1993086.18127308,3978076.9986990998
22,0,3,0,1,4,1666945.17663115,4607564.847886
27,2,2,1,1,6,1966486.73532452,2454244.31875776
20,2,1,0,1,4,1280532.6759338998,5099141.51882982
21,5,0,0,6,11,1952219.32177013,3097947.39187899
14,6,2,0,7,15,2286736.86367604,8871454.58762117
11,5,1,1,1,8,2109446.07124244,951191.451431539
33,3,2,2,1,8,2096676.38128023,5423582.00281658
20,6,2,0,7,15,2370450.07609987,9083579.34359888
35,6,0,2,0,8,1907933.28671571,4031707.38508542
35,0,3,0,0,3,1197571.03001238,1513297.44147957
13,3,0,2,5,10,1720908.33088516,3019945.74813062
35,3,3,0,6,12,2167752.93169705,6260774.29580582
10,6,2,2,3,13,2363500.18620645,8279419.65854496
37,1,3,2,6,12,2374830.89480798,5828462.50453841
23,0,2,0,3,5,2061233.6064159,3410560.22533502
13,4,2,2,5,13,2305700.23505892,7281456.4882968
20,0,1,2,1,4,1424679.51150635,5064530.71007536
16,3,3,2,1,9,1988580.8064663003,5328151.7484327005
22,6,2,0,5,13,2233775.18630245,6482051.04519543
25,5,3,1,0,9,1679396.68959849,3757549.76913419
23,2,3,0,3,8,1425143.24561426,5011852.54468298
17,0,2,2,3,7,1651627.93985279,4537263.648055901
25,3,1,0,2,6,2119041.33772679,3511041.81033099
29,1,2,2,2,7,2216527.15064227,9092561.86521391
14,1,3,1,3,8,2360158.59358649,6126644.33635197
40,6,2,1,3,12,2175630.82694366,7637789.48869692
39,4,3,2,7,16,3278312.46200114,9724784.13532837
32,0,3,0,2,5,1646848.29337055,2140512.51855388
19,2,2,0,4,8,1922774.5973731999,5830098.41399605
23,3,2,1,0,6,1414228.1005463002,1493228.2818201
35,5,1,0,2,8,1752303.20228332,3728961.38327329
33,4,1,2,4,11,2375365.77701788,5059878.95748235
32,4,3,1,1,9,2016390.98495448,7490999.20056662
27,1,2,2,7,12,2376791.94871111,7589521.59765626
23,6,1,1,3,11,1795359.08587876,1364982.88884577
34,0,1,1,7,9,2227804.14141509,8614440.07543725
19,2,0,2,4,8,1875646.99962315,4155775.32575682
24,1,0,0,5,6,2042338.90444306,5612246.31204334
39,3,3,0,7,13,2319029.6318646,7824065.77376492
30,0,1,2,0,3,1190872.8132046002,5018479.47857297
23,6,1,2,6,15,2851452.7422446,6281184.02605523
33,2,3,2,1,8,1754718.87172416,2762529.50699585
20,3,0,0,2,5,1564485.52179769,6641250.201999599
17,2,1,2,6,11,2312823.13420226,7021505.06358465
28,4,0,0,2,6,1405899.94471951,5002248.26325227
30,0,2,1,0,3,1484904.68565393,5151992.94186151
30,4,2,0,4,10,1603053.93813423,5500377.63612069
15,3,1,2,0,6,1536302.87355403,3478834.73250584
34,4,3,2,3,12,1485111.20398621,8539580.02051359
26,2,2,0,5,9,2112697.83185673,5960925.60384389
31,1,3,0,2,6,1577333.03394129,3673582.32430844
32,3,1,0,6,10,1776474.46800399,6645585.01075114
21,2,3,0,2,7,2000157.04261345,4647531.02956066
35,3,1,0,6,10,2269662.10167889,8754393.32720207
22,2,2,0,0,4,1072684.96947451,3938546.39057521
29,5,3,1,7,16,2478329.09626733,12196847.631407302
32,2,1,2,2,7,1424176.38295511,4111496.86742994
11,3,1,2,5,11,2140797.42887924,6058804.84257307
18,6,3,1,1,11,2012809.34162474,3838172.4693489
27,0,0,1,3,4,1392303.65088108,2957724.47666118
10,6,1,0,6,13,2584222.33372847,5956199.01745768
19,1,0,2,3,6,1367821.89772792,3510898.31983945
26,1,0,1,0,2,1285487.31690502,1685511.11154664
33,6,2,2,4,14,2540339.50237524,7168876.34621897
31,6,3,1,5,15,2872166.07212458,6083315.7185932
14,4,2,0,2,8,2064613.1263676998,4533483.22725576
11,6,3,2,4,15,2303563.35024448,8197535.81180215
25,1,0,0,4,5,1444555.32985723,3386155.46068077
30,5,2,2,7,16,2493008.88827594,6623914.31515376
28,2,1,0,5,8,1652561.82800442,7285159.55856081
19,0,1,2,6,9,2046043.03262782,3411834.14197798
28,2,0,1,3,6,1629727.33954063,5176060.62795476
18,4,3,1,7,15,3216017.60389699,8582065.71668572
19,1,2,0,3,6,1696054.18347156,4955242.541349299
38,2,0,0,2,4,1704772.3823578998,2685533.31120111
33,3,1,2,4,10,1526934.03879922,3833455.38770334
36,2,3,2,5,12,3083450.47301042,3812056.36154747
22,5,0,1,0,6,1685321.97218699,5448385.04302097
24,4,0,0,3,7,1460137.22031614,7022496.06255952
19,5,2,2,3,12,2273674.14394099,6757745.79078018
32,0,3,1,4,8,1438173.11526527,2883117.23435771
26,2,2,0,4,8,1099887.6927593001,4679058.47721942
33,0,1,1,4,6,1460820.14630988,7726862.69426744
22,6,3,0,1,10,2070494.57327949,3359487.60411403
21,4,3,2,3,12,1719637.70858834,6630347.85704265
39,3,0,2,4,9,1997246.7640771999,4326599.12410532
24,0,1,1,0,2,1065984.46637984,1879395.93097046
13,3,1,2,6,12,2384758.39037319,6165725.33022123
23,5,1,1,1,8,1552191.96869588,4380474.42484686
40,4,3,2,3,12,2444933.73195226,9981105.27474227
10,0,0,1,4,5,1400726.97412406,1903779.07273843
17,0,0,2,0,2,1254378.88295032,6394734.34195401
40,5,3,1,7,16,3203963.63112896,7968157.81266648
25,1,2,2,2,7,1703291.68432753,5699679.99557449
32,2,3,2,5,12,1836491.12610531,7235610.75716014
36,6,0,1,6,13,2395567.60682802,9345080.64799019
20,1,2,0,2,5,1545894.35036128,5460434.70140434
27,5,3,0,3,11,1594569.13427447,5783687.41327267
40,1,3,1,3,8,1906168.15983958,6181877.38991205
29,5,2,1,4,12,1691319.66355721,5637226.94335619
13,2,1,2,2,7,1562391.47101126,2291603.65521928
21,5,0,2,6,13,2559178.76821568,8168663.27385331
36,3,1,0,6,10,1730634.68433195,6157689.82261064
29,5,1,2,6,14,2273762.97078752,4875998.31835689
19,2,3,0,4,9,2458023.85226811,5937997.06509529
39,2,1,1,5,9,1964238.39286602,6566764.18452302
40,0,2,0,0,2,877640.51673274,4963008.30195391
29,2,1,1,4,8,1742792.02299162,4192252.94211747
33,3,1,0,3,7,1831487.19231659,5024340.16134579
28,4,2,0,1,7,1797943.77850475,4130239.4379649004
13,6,1,2,0,9,1413310.46641328,6416593.75909466
34,3,1,1,7,12,2300916.0061914,6597636.88522889
19,4,1,2,3,10,1927696.49559208,6629172.02090679
32,3,1,0,3,7,2067146.04499363,3065430.09017292
22,5,0,2,7,14,2706011.97771229,6760734.54952825
26,2,0,2,4,8,2267678.99071919,6301457.21951615
21,2,3,1,3,9,1724156.12226718,3629917.15416292
14,6,2,0,4,12,2454374.06577277,3926557.71565122
34,1,2,0,5,8,2323393.54828887,2841367.68444838
18,6,0,1,4,11,2098441.66687346,5265946.51234456
12,0,3,0,1,4,1327174.16360582,2450327.19975553
17,0,2,1,1,4,1204786.07594377,3135195.66846097
21,4,0,0,4,8,2318374.74801829,4126794.59468079
12,5,2,0,3,10,1937498.49870699,5039195.62923026
22,6,1,0,0,7,1282077.91287692,3274957.34294382
30,6,2,1,2,11,2499805.00481254,8589495.59911216
37,4,1,1,7,13,2241079.11007605,1814191.20209438
19,4,1,1,5,11,2087695.77377347,5980973.78404329
37,2,2,1,0,5,1967537.3166669,4170690.19083908
19,3,2,0,4,9,1559495.48279853,5824674.19220446
17,1,3,0,5,9,2139629.86067599,6372228.71328862
39,3,1,2,3,9,2127475.97042434,7194744.86196979
29,3,3,0,4,10,1908308.50453806,5472486.24013125
26,6,2,0,7,15,2234769.23330653,5358102.5140443
34,3,0,2,3,8,1275650.16245172,6236825.86064837
10,4,0,2,6,12,1379408.09211359,4356718.46624541
34,2,0,1,6,9,2384699.81698558,7058834.84793914
39,1,2,2,2,7,1597475.67464383,6997505.80398562
39,6,1,2,1,10,2316360.90033054,5058841.35079387
31,2,0,1,5,8,1460561.10051473,4893526.87235856
37,2,2,0,1,5,1502929.01292174,7367815.58404212
26,1,3,2,3,9,1277658.88292322,4990577.74676207
17,0,1,2,5,8,2324130.40065889,5461347.41902458
38,1,1,2,2,6,1882363.97911797,5629677.69564439
38,4,1,0,2,7,1495608.42849678,5422341.61891564
36,4,2,2,4,12,2992971.25269324,5893500.03588664
19,1,3,2,3,9,1862984.4361220002,7470851.40354817
34,1,1,2,0,4,1433622.03217503,4187762.00300071
40,6,1,2,1,10,1760241.5808738,5987296.01747346
32,6,0,1,2,9,1611919.82454948,5398416.06404518
36,3,1,2,3,9,2236684.90738717,6115107.52457877
23,2,1,0,4,7,1418576.36631265,2751416.31468412
18,4,1,1,5,11,1938936.6534224998,9995076.22563149
29,2,1,1,4,8,1048429.52550482,5891036.08237982
22,3,3,1,7,14,2796912.6947433,8781536.56018828
19,2,2,0,6,10,1840397.92902852,6744604.92323044
32,4,1,1,5,11,2418713.35731469,5659881.27723759
33,6,1,2,5,14,2969306.66430689,10107020.693751499
21,3,2,0,6,11,2297180.23278541,7248934.63093496
34,0,1,1,0,2,1189963.01416609,5064116.82557955
17,4,0,2,3,9,1521093.37608876,2614917.79056414
24,4,0,0,3,7,2212451.22154073,3984707.65022426
14,6,0,0,0,6,1490176.62006499,3998246.23614819
19,1,1,1,7,10,1309132.83440823,7263876.57779835
40,1,1,0,4,6,2014587.08883607,3699388.65734361
36,0,0,1,4,5,1376435.21030403,3382820.70389095
13,5,2,0,3,10,1703050.08486269,3468760.11505768
22,3,1,1,1,6,1411146.74213299,4353815.44394821
11,5,1,1,5,12,1655409.97585554,3611403.83113913
27,1,3,0,5,9,1593634.41286136,3087377.85676534
11,3,1,1,1,6,1557705.71313857,8465179.20759165
15,3,3,0,6,12,1824760.80802806,6028747.32187072
29,3,1,1,4,9,1745910.71755457,4722420.00592648
38,1,0,2,6,9,2208559.49110309,4193582.20759506
17,6,2,0,1,9,1912256.7623028,4249107.39685003
27,3,1,1,7,12,2133951.96964903,6745427.71488621
29,1,2,1,5,9,1976190.52744767,7908051.18686972
20,4,2,2,4,12,1671203.09055294,7058401.99728163
17,1,1,0,7,9,2065458.96051436,1287918.39600751
36,2,0,0,4,6,1864910.25575346,4146991.68754706
17,2,2,2,4,10,1925598.52505082,5359939.23819132
13,1,0,0,1,2,1014530.13403607,6369977.32177373
31,0,3,1,6,10,1999320.2078244998,7963917.152058099
13,1,2,0,4,7,1855938.70185152,8373110.10423388
26,5,2,2,1,10,2051144.11833686,3913657.39075758
28,5,3,1,0,9,1961198.94669468,6600404.49510566
22,4,0,0,7,11,2365648.21276484,4784405.98469689
24,5,3,2,1,11,2489557.24939429,9102676.77796893
11,3,3,0,4,10,2153005.46104921,4389498.05043164
13,2,2,0,1,5,1974024.99387716,8384826.77588205
10,3,0,2,4,9,1753682.73922947,6991807.24463111
25,3,3,1,1,8,1506551.38017432,6544163.71399372
35,0,0,0,1,1,970919.667166806,3006162.86200666
21,2,2,0,5,9,1639479.59957005,1692488.30615228
22,6,3,2,2,13,3071501.84224027,2578298.01247791
15,3,0,2,5,10,1886913.63776624,7650018.51179754
40,1,0,2,2,5,1714208.51778692,5945929.88094669
11,2,0,0,6,8,1747160.8332151,6057618.92492422
24,2,2,1,3,8,1923824.84616082,5856187.767296401
35,5,3,1,0,9,2239279.97966834,5308801.3447444
36,4,1,1,4,10,1107087.62676796,6279831.44779893
39,0,2,2,0,4,1714229.55874452,6118088.55056643
37,3,1,2,7,13,2467731.73476025,6655917.97217014
11,6,0,0,0,6,1652523.74699963,2402877.42637773
33,2,3,2,5,12,1941943.50844434,8412660.42777878
34,5,2,0,6,13,1867168.3441974,7883915.06259661
35,3,1,0,7,11,2208784.3167974,4215915.47281132
15,5,2,2,7,16,3190709.60382419,8643514.70944833
34,2,2,1,3,8,1915334.00447507,5176276.23128281
14,1,3,2,5,11,1800515.18257505,6425138.87627
13,0,3,2,6,11,2773130.88378016,7633766.95030677
22,0,2,1,5,8,1554440.29831492,6196602.94492927
23,4,2,0,6,12,2458271.24277278,8034624.11357757
22,6,1,1,7,15,3351572.58289923,5686277.94122375
18,3,1,2,6,12,2052645.77129318,6197524.20460744
10,0,2,2,3,7,1676905.23518722,3567207.35556785
13,0,3,2,6,11,2135153.09992494,7329365.43353883
33,3,3,2,3,11,2151973.43791586,8242209.974624201
21,2,2,0,7,11,1626123.57069794,5951589.91451878
27,5,0,0,6,11,1304993.92390139,7251236.66230873
38,4,1,1,6,12,2304251.37418536,1151301.44611163
38,4,3,1,1,9,1594112.66851822,5647936.16861288
14,0,2,2,7,11,2779727.2836244,7859954.292204902
12,2,1,0,3,6,1786343.88097355,6670076.53523613
36,6,3,2,7,18,2684959.20625896,7192038.18543374
27,4,2,2,5,13,1721937.93438857,8790812.817404801
31,6,0,1,5,12,2169337.73718171,5969211.53807736
14,5,3,1,1,10,1836870.15175334,5042162.84575883
30,0,0,2,5,7,1607244.08297856,6925044.04227647
24,0,0,1,2,3,1294148.3659657,6882997.57733172
20,2,2,2,0,6,1525924.55672261,4538592.9570088
22,4,3,2,6,15,2704134.38431795,6635335.5188358
18,4,1,0,1,6,1276645.59307449,4696318.07241519
38,0,3,2,7,12,2007778.24761907,3313464.17371699
23,1,0,2,4,7,1849350.57656266,2729332.31267867
11,2,0,2,6,10,2467852.7157672998,3452370.91145312
30,2,3,0,7,12,2158253.71401965,5477538.21645081
13,2,1,0,1,4,1273482.96884851,4424573.23372116
21,2,3,0,2,7,1502680.2746213002,3389964.23972984
13,1,0,0,4,5,1433540.64994627,1872517.78227277
32,6,0,0,4,10,2258032.31679734,3396328.65764391
28,3,0,1,1,5,1822537.72560513,4044122.01495446
36,3,0,0,1,4,1155164.17265883,1613212.06285658
27,5,0,0,3,8,1531010.01369716,4200459.9766646
10,0,3,1,7,11,2681904.47728432,4248350.22798069
39,2,1,0,5,8,1939283.13449313,4573464.64100844
13,2,3,0,4,9,1870292.56705565,5585099.06882543
27,3,3,0,3,9,1567935.73207534,6520932.46593368
12,4,0,1,4,9,1621731.51198558,6132503.89308254
29,3,1,1,0,5,1283264.14693783,6274995.20826942
36,0,0,0,1,1,1057128.2109169,1710114.48900977
21,3,2,1,1,7,1213083.75200393,5465819.59210391
12,5,3,1,5,14,2445388.1767125,5986945.48416788
14,0,0,1,6,7,1691973.68108107,1614258.36528635
10,5,3,0,7,15,3297059.62554073,11365108.885749301
34,5,0,1,3,9,2110089.34776664,4318881.65154513
11,3,1,1,3,8,1757392.36450414,6375131.318699599
12,4,2,2,1,9,1824500.57405187,2612816.13616128
21,3,1,0,3,7,1670830.1085591998,2332330.98812175
33,2,2,2,1,7,1326310.92706189,6218922.45405929
13,2,3,2,4,11,2571757.63686906,4553393.93466674
24,6,2,2,3,13,2404333.69189014,5637393.29746272
32,2,0,0,6,8,1729415.72237107,3883491.36381025
29,2,0,2,0,4,1371344.84939848,6444803.33141107
25,1,1,0,7,9,2221183.95278938,3802638.81308729
37,2,3,0,1,6,1634012.91248029,3840544.98093407
15,4,3,0,5,12,2420848.8467154,6045882.74454492
30,4,0,0,7,11,2284691.25522698,3572913.03362011
24,4,3,1,1,9,1786993.22528817,5829282.02520501
27,0,0,0,5,5,1827219.66507143,4888675.93320974
17,1,3,0,3,7,1566330.58271246,5942485.36629611
10,0,0,0,7,7,2067484.90735128,5231395.57100243
13,2,3,2,7,14,2671347.53105072,8721514.22199995
40,5,0,1,4,10,1189793.20862761,6339603.92645426
26,4,2,1,3,10,2201911.78504093,3740317.31289078
22,5,0,0,7,12,1818917.36815511,6181675.78033529
23,6,3,0,0,9,1872767.37010002,5841003.10842818
33,6,2,0,5,13,2260037.0894996,6965856.74100455
13,0,0,1,3,4,1253996.60817688,4436832.89569715
33,2,1,1,0,4,1544943.87943715,2335824.06279216
18,4,3,0,0,7,2002134.56918431,2875455.13569384
38,5,2,0,6,13,2469127.40959034,8097214.03980043
36,6,1,0,6,13,1862886.60551359,6943462.78621586
29,4,0,0,0,4,1645142.00385378,5210364.94462861
28,1,3,1,1,6,1655360.63458399,6331881.359596499
13,0,2,1,6,9,1807417.48826149,6113429.11259667
30,0,0,1,0,1,1231232.60530844,2655039.8003332
23,4,0,2,6,12,1616200.17603638,4743025.24995797
40,6,1,0,3,10,1796432.18062356,6567128.03726742
40,4,0,1,2,7,1790237.04493931,6358781.91911753
40,1,3,0,6,10,2401808.48756484,2040954.09067053
40,3,3,0,6,12,2299476.267281,4528604.69188598
19,1,3,1,7,12,2342783.81533873,6399019.39803387
36,3,2,0,5,10,2090618.91916401,6641012.43792507
30,2,0,2,2,6,1930786.63968806,3493332.72352769
37,1,1,2,5,9,2615483.54618823,1820335.55958792
22,6,2,2,3,13,2454772.15855412,11130544.4969786
14,6,2,2,6,16,2009641.50649849,11847063.9154798
19,4,1,0,3,8,1632415.79726511,4338179.71422578
22,2,1,1,2,6,1253026.46637196,4855191.25015883
19,6,3,1,1,11,2168651.87274315,6356935.98808376
39,1,1,2,6,10,1964577.43808896,4472125.71910624
27,0,0,1,1,2,1250457.45129205,5398693.74512176
35,3,1,0,7,11,2181218.75720301,3516453.38827702
14,2,2,2,0,6,1513445.28469061,6871536.19474222
35,4,1,2,5,12,1771049.3763001,6466769.42602248
26,1,2,1,5,9,2291789.68917917,8051049.424036399
23,6,2,2,3,13,3106325.00390475,6402821.23209366
13,3,3,0,4,10,1810557.54147321,4799355.61226704
18,5,1,1,6,13,2564038.51943331,7686233.45339645
19,6,0,2,2,10,2114058.57739619,4625519.79709521
40,6,1,0,2,9,1979577.68500707,6073741.53772892
33,3,1,2,6,12,2145959.13380859,7449718.17933876
18,6,2,1,4,13,2131339.24040674,10427433.788260302
40,5,2,0,1,8,1557763.12753024,5155909.71439016
19,5,2,0,1,8,1511610.01437031,6723602.38451255
33,3,0,0,2,5,1404325.32683324,3934034.56667005
40,4,2,1,0,7,1959730.53785903,5900921.75914832
11,4,3,2,3,12,2065186.66144491,5675857.66598483
40,2,1,0,0,3,1212666.14449905,3876338.25619889
36,0,1,2,4,7,1980803.47085223,6458778.46674049
30,1,0,0,1,2,942740.3871442409,5004981.94013788
40,5,3,2,0,10,1866471.82066077,6532480.45101225
14,1,0,2,3,6,1389379.43815633,4907105.74276596
31,0,0,1,3,4,1474586.96355373,2851011.12584081
26,5,3,0,6,14,2430194.30875043,9585067.00134416
16,5,3,0,3,11,2332452.12812182,5236007.49992021
34,0,1,2,3,6,1251528.12912143,5330260.56562529
20,6,0,2,0,8,1564819.6238628,6076087.73224694
35,5,2,1,5,13,1630354.92196077,9638487.42365731
25,0,1,1,0,2,889168.578838219,2634748.63559895
25,1,2,0,2,5,1544333.70277959,2123056.95167613
29,2,2,1,5,10,2324889.23971693,6905280.67387165
21,6,3,0,4,13,2008809.54105936,6910636.13559306
21,5,3,2,0,10,2290588.25542244,5559291.33740043
39,1,2,2,4,9,2474389.33891706,5803768.86739033
37,3,3,1,5,12,2208450.84880333,5001600.63597355
25,4,3,0,1,8,1598753.84932418,5202151.53923715
23,4,3,2,0,9,2169129.90649167,5008234.15768137
18,4,0,2,2,8,1847738.13000371,6099036.90683346
20,6,2,0,1,9,2298914.61319226,6681779.62724761
14,1,3,0,3,7,1849117.82606592,4356908.21837485
37,2,3,0,2,7,1757421.58240859,1838846.82124604
32,2,1,2,4,9,1805906.83757274,10131451.556576598
25,4,0,2,3,9,2237463.56221419,4154814.19598818
23,6,2,1,3,12,2101073.46630681,6353195.27931414
29,0,0,1,4,5,1765534.74315427,4130106.19110931
25,4,3,2,1,10,2491840.72363632,4899249.47169053
13,2,2,2,3,9,2221349.13999868,5557976.76997025
22,2,3,1,1,7,1216706.09226009,3416360.25797584
23,1,2,2,6,11,1615078.36585605,4104137.85926208
40,2,3,0,3,8,1634413.83486763,4034936.34143755
22,5,3,0,4,12,1947168.12565056,6488386.33083594
20,1,3,2,7,13,1986170.07981144,8237821.57229439
14,4,3,2,0,9,2402170.65947622,5638899.05769594
27,3,0,1,3,7,1587366.44335042,3816170.51064752
26,5,1,2,7,15,2629507.72367542,5141007.3490577005
40,2,2,2,2,8,2060901.71806818,8689596.87754899
15,1,2,2,7,12,1975193.08451436,7311268.86026692
37,4,1,0,7,12,1680321.79800846,9789574.85609151
19,4,3,2,7,16,2114618.84567587,6540029.33206881
22,5,2,1,7,15,2639435.12979888,3434341.51455392
23,5,1,2,5,13,1847685.15799284,4629109.8236226
11,4,3,1,0,8,2006107.91775054,7663928.20714964
18,1,1,0,2,4,1047122.92537572,4004044.45692677
18,0,1,0,3,4,1451360.52403673,3693315.04319646
19,5,2,0,2,9,2138540.12727199,1113262.15506166
39,4,0,1,2,7,1541897.16982298,3429531.1820551003
13,0,3,0,5,8,1663875.53497238,6660513.71475909
12,5,2,0,2,9,1894765.74785878,5747579.71164433
34,6,2,1,4,13,2604308.86347672,9733442.82832093
35,0,2,2,2,6,1257181.89793279,2800009.80319016
16,3,3,0,3,9,1903694.36360687,4787559.97094012
15,3,1,1,3,8,1415312.85962279,6919265.7961347
31,4,2,1,0,7,1397255.11974181,6316729.60918378
20,6,1,1,1,9,1964766.08273035,3794948.58015408
25,3,1,0,5,9,1262439.49427674,4058106.00609642
10,0,3,0,3,6,1862178.33223706,2874559.85374925
12,6,1,2,5,14,2446386.06611531,7595002.85488978
19,0,1,0,7,8,2318616.4288617,6797246.33827137
23,0,2,0,1,3,1434680.72476645,3375616.75866899
27,3,0,0,5,8,1695851.69261594,8470880.23553215
40,0,3,2,3,8,1608660.93487637,6656632.03285721
22,0,0,0,6,6,1767069.74835979,5101456.23360991
33,5,0,2,0,7,1811777.88939415,4535078.21980133
35,1,0,1,5,7,1726780.19266551,1852548.50334149
30,4,0,1,1,6,1560340.61441155,5956737.80109871
30,3,1,2,7,13,2632748.88135259,9028926.66004327
28,4,3,1,7,15,2113008.66002291,7811178.94893823
37,3,0,1,3,7,2425798.30777118,2637848.53202689
28,6,3,2,6,17,3237535.86248654,6870838.76714327
27,3,3,2,0,8,2247361.21682401,4725428.85162924
32,4,3,0,0,7,1766929.92707051,4504218.23992636
39,3,0,2,1,6,1524270.2532418,6062877.89904197
39,3,2,2,7,14,2634792.21188311,5799736.20704855
31,6,1,1,5,13,2622771.91384258,4325530.13724599
38,0,0,1,6,7,1680844.45075773,7508828.57041982
11,1,3,1,1,6,1439283.62414013,2573713.14841542
39,2,1,0,0,3,1145374.23812688,3144678.05785685
25,5,1,0,3,9,1208660.99582666,7571677.44534149
19,2,3,2,4,11,2144509.93604401,6436019.03280092
38,0,1,2,2,5,1371861.30572203,5120113.88822604
39,3,1,2,3,9,1508418.4460326,8435119.36868265
13,2,1,0,3,6,1660712.54080534,5880875.981788401
14,5,0,1,0,6,2016720.99278644,2290214.91987817
36,3,1,1,5,10,2421881.87861431,4640995.80480641
20,3,1,2,6,12,2120106.44056422,9226830.11376786
36,1,1,0,3,5,898529.725412566,6549487.71164282
10,6,1,1,3,11,1491793.11970347,6461146.89351695
34,1,2,1,6,10,2184432.19527876,2744093.51017639
28,6,2,1,3,12,2906351.59795087,3655143.22202649
26,0,0,0,7,7,1521994.43122838,7277962.82944304
19,0,3,1,4,8,1654360.80167584,5555487.52813644
31,5,2,2,6,15,2083769.24123686,5638904.90782306
39,0,1,2,0,3,1511771.88042261,1511771.88042261
38,4,1,0,7,12,2097767.49959372,5710992.58686256
30,2,0,2,0,4,900735.348795059,1052566.59007399
26,5,0,1,5,11,1454138.66033553,6541253.616422099
35,4,2,2,3,11,2168835.9374313,4379649.24457679
22,6,1,2,0,9,2654768.45521143,6444387.86344551
18,2,1,0,7,10,1989358.73637037,4294118.33582648
21,4,2,2,7,15,2710335.8900758997,6360325.29468055
23,4,3,2,6,15,2618063.29249296,9550403.03586659
11,3,1,2,4,10,1885713.25039454,7588599.08038486
39,2,0,2,1,5,1354026.51123273,6285360.49011129
24,3,2,0,0,5,1431990.75899233,4069579.52724819
39,3,0,0,6,9,1598497.28557887,6039349.17008633
17,2,0,0,1,3,1602856.06632285,1561676.28756602
23,0,1,0,3,4,1495392.63247592,4981894.3805313
38,6,1,2,3,12,2526101.48423438,3643019.543404
23,4,2,0,7,13,1792373.29682878,5062627.78396884
35,3,2,2,0,7,1841766.19165606,2884441.08860701
33,3,1,0,6,10,1885775.736941,5161181.70771987
20,3,1,0,6,10,1763728.5306726003,8686956.95779407
20,4,2,2,2,10,2050417.34329045,7217366.99743195
31,3,1,0,7,11,2281074.1024457,5231187.27314441
24,3,3,1,2,9,1944190.63025606,7617535.36009196
39,0,2,2,0,4,1579014.00260665,4054718.50710678
13,5,3,0,7,15,2113299.82834075,7149709.46579256
25,0,1,1,7,9,1540017.65497836,6375931.57781231
10,0,3,1,5,9,2087857.25659672,3794645.13514366
26,1,3,2,5,11,2203656.42610982,8040038.0881748
24,0,3,1,5,9,1660869.43232016,5480107.87520889
37,3,1,1,4,9,1639049.08603936,5590044.82979206
16,6,0,0,2,8,1874797.06822711,7094522.38459548
23,1,1,2,3,7,2083030.56970875,4436669.92930121
36,3,1,0,0,4,1881345.66950102,5378117.47253087
15,3,2,2,5,12,2423966.34266346,5156996.88211857
11,1,2,2,0,5,1780529.36004038,3605795.66823199
12,1,2,0,0,3,1051261.79821614,1426689.057802
16,4,2,0,5,11,1987053.06170296,4810094.20379287
11,1,1,1,3,6,1473084.40939337,4399041.88774484
12,5,2,1,4,12,2085929.80400611,7024681.85649657
18,4,3,2,0,9,1957677.54354444,7069415.32744398
13,1,3,2,6,12,2565014.83079922,3784584.47066736
37,5,1,2,5,13,2573705.27295707,8877625.01183428
38,5,1,1,1,8,1778109.77569633,6523654.09061213
12,0,3,0,4,7,1707955.75162727,3060598.394928
38,1,0,1,4,6,1765754.07064309,4785032.66734424
16,5,0,1,5,11,2089259.84161336,9919141.96745827
27,1,0,2,1,4,1486692.59584643,1486692.59584643
14,5,3,0,3,11,3091802.49755316,5766816.49248261
33,1,2,2,7,12,2475396.19675559,8602602.56412083
39,5,0,0,2,7,2123585.57471191,2603271.48336313
28,5,0,0,2,7,1196944.63544256,5215326.43438807
22,5,2,1,1,9,1922462.85184992,6656801.35325922
11,4,2,0,2,8,1787969.68689537,5245438.52658576
23,0,1,1,7,9,1837492.59417237,5638359.03215012
14,2,3,0,2,7,1352124.46646966,4969448.55977003
31,0,2,0,3,5,1631105.43138979,1289206.50697333
22,5,1,0,3,9,1833000.00283625,5350312.59544035
36,4,1,2,3,10,1450087.34791042,6889151.32364245
34,2,2,1,0,5,1732432.0264643996,2817558.49206705
11,1,1,0,4,6,1919142.00344576,4787237.337484299
35,1,0,0,4,5,1373177.66178153,5699896.01494996
34,3,2,1,3,9,1724116.33071543,6878685.47550736
17,0,0,0,5,5,1601389.45968571,3477534.35426324
27,3,3,1,4,11,1773750.11477608,9337729.65041047
15,4,0,2,5,11,2034531.13961191,8886114.490143301
23,4,0,2,7,13,1597821.44617446,11161868.630199
18,2,3,1,6,12,2304820.84312374,6290745.69062404
29,6,0,0,2,8,1689194.07459936,6863535.652605901
10,2,2,1,6,11,2683709.63640061,3011553.44366947
40,1,2,1,0,4,1261264.76287311,1959675.18906699
36,4,0,2,7,13,2304459.53037817,1335910.56499067
15,3,3,2,3,11,2086326.68407395,5091873.16096264
32,2,3,1,3,9,2292599.9304796,4359028.80506906
19,0,1,1,7,9,1650114.13598271,7755505.74787457
21,3,1,2,2,8,1266079.00864578,5646358.32008596
33,6,1,2,0,9,1863250.74158093,5890708.87432596
13,1,3,1,2,7,1818147.49040301,4817906.8000986995
10,3,0,1,5,9,1809061.22333944,5777626.89136606
36,1,2,2,5,10,1929051.01997649,6240622.62435156
34,6,2,1,7,16,2625596.49157181,10205007.078627
12,6,1,0,7,14,1982670.19879492,5774836.25483353
30,6,3,0,2,11,2513451.10443216,11073339.6111062
13,5,3,1,1,10,1672686.71116727,4657846.83351196
29,6,3,0,2,11,2730441.3910288,7671450.20786267
25,5,1,2,4,12,2731174.42069895,3744980.39451227
26,3,3,0,0,6,1572119.26170399,3646317.03157878
26,1,3,2,2,8,2082450.04010061,5883043.55997471
11,2,1,0,3,6,1362038.54621545,3761486.12133795
35,1,2,1,0,4,1302965.88606458,4228223.68609921
11,2,0,2,3,7,1351540.25361853,4933865.95536278
11,2,3,0,0,5,1405490.38743076,2805530.13206721
14,6,3,0,1,10,1613035.8856008998,5577474.87643682
25,0,3,2,0,5,1471304.35741348,3140082.11171367
21,5,0,1,1,7,2077716.93703861,8791122.55644282
14,4,2,1,3,10,2545054.00846098,3911705.01270441
23,0,0,2,6,8,1740891.08043249,4248678.05892011
37,1,1,0,2,4,952009.943913794,5605737.71717253
36,3,2,2,1,8,1888555.61383269,7006161.68798756
15,4,2,2,3,11,1823755.5422371998,7045270.16156382
15,5,3,0,3,11,2213093.30683751,7922934.795595501
10,5,1,0,3,9,1918266.55734075,4975646.75871727
34,5,3,1,1,10,1751629.08902101,4781592.79476067
16,1,3,0,3,7,1434269.22533811,5508910.35507243
10,6,0,1,4,11,2150558.12422381,6630504.33831581
10,3,2,0,3,8,1554918.17766228,5917222.3403359
27,3,3,2,4,12,2225292.0017942996,8166884.95326908
37,6,0,1,7,14,2000475.18964014,10984924.9655388
29,5,1,2,4,12,3263957.90488799,7188482.84794382
16,3,3,0,7,13,2478313.66914589,6778381.67663822
27,6,0,0,7,13,1689605.00481247,7193531.58312841
25,3,2,0,4,9,1452539.26860135,4775532.647048
13,6,0,2,1,9,1355690.50375822,5317498.03592377
28,0,0,2,6,8,1203037.34432475,3392131.87074705
35,1,1,1,0,3,1534412.26669235,2815359.56144397
28,0,1,1,6,8,1608514.42030721,4060668.2415472
15,2,2,1,2,7,1593080.01774357,4254945.32172529
26,5,0,0,0,5,1575881.67724579,4529348.37430076
19,3,0,1,3,7,1458299.96524741,3750231.55654259
22,2,0,0,4,6,1384505.94912374,4285044.46116883
23,3,1,1,5,10,1270566.94340568,4094699.04857782
17,6,0,1,6,13,2496225.58887851,6713685.07721502
19,4,1,0,1,6,1688593.54992372,2569465.67408263
28,5,0,1,4,10,2118458.46966156,4087749.222739
23,1,2,0,6,9,1893572.88202751,4404198.36905782
19,6,3,2,1,12,2349749.77917951,5874966.4817811
13,5,2,0,2,9,1787974.25753411,10828155.862016499
15,4,0,0,5,9,1862166.09588943,7919571.26690547
26,0,2,0,4,6,1621335.23307043,3974417.44866218
40,5,0,2,5,12,1940390.06274016,6541219.81856372
19,3,0,1,5,9,2660885.18045789,7847236.77252805
32,0,3,2,7,12,2643823.63409371,7207600.29557512
12,6,3,0,1,10,2549238.35624511,4707812.95889818
36,2,3,0,5,10,2252136.6509093996,5335278.83688603
22,4,3,2,1,10,2159657.43255033,5488508.89058928
28,5,2,2,2,11,2549623.79900132,8064428.43204456
15,4,0,2,5,11,2450556.67349718,4056083.25981451
24,1,0,1,0,2,957551.249268544,5095091.28659123
40,2,2,1,0,5,1571001.68359913,7858977.11058158
23,6,0,2,7,15,2066787.73997585,7497341.76847292
21,4,2,0,0,6,1265740.72982891,3123443.14364109
17,0,1,1,0,2,1397515.13531974,3311154.3788767
13,1,1,1,2,5,1513996.09003287,3052178.62033856
10,2,3,1,7,13,2166620.72570336,5201841.0067655
17,3,1,1,6,11,1491657.82238739,7809460.2159026
19,1,1,1,7,10,1745518.54770977,5035580.19863023
12,3,1,2,5,11,1987161.35664647,5006524.13788462
19,6,0,1,0,7,1457503.81260246,6172365.55482251
27,2,3,2,1,8,1897957.13120497,247895.52318812
24,5,0,0,0,5,1784247.49310021,3294709.61724911
10,1,1,1,7,10,1867226.70588112,5897874.87261339
22,5,1,2,2,10,1960300.60841306,6891246.89445567
33,1,3,0,7,11,2036348.13977375,6905278.13364297
39,2,2,2,3,9,2076410.72599405,3072367.57995699
39,0,1,1,5,7,1722524.08797423,7679683.73145577
23,2,2,1,6,11,2276272.81744627,7250725.00587546
15,5,1,2,4,12,1996528.14753144,9016125.95712565
25,6,3,0,3,12,2975304.45044314,5790097.56814343
16,4,3,1,3,11,1881260.82221275,5551019.69020836
21,4,1,2,4,11,2159992.61798916,5949611.07803943
37,4,3,2,6,15,2888680.47574607,9120146.18410806
28,4,2,1,5,12,1840731.9009786998,5502655.21501347
30,6,1,1,4,12,2640276.29885093,11254351.602819
27,3,2,0,2,7,1719731.67347099,3266209.21803999
35,2,2,1,7,12,2215572.9347841,4656736.43406403
28,1,2,1,4,8,2097015.94729912,4785987.14812646
15,5,0,2,5,12,1954798.09902968,6970474.42598775
19,5,2,1,1,9,1973539.47267617,4217519.23437461
20,2,1,2,5,10,1601286.66329884,5138445.80879577
22,1,3,1,6,11,2060587.22151675,7424390.27475521
38,2,2,1,3,8,1191697.74461293,9644202.15537011
33,5,3,0,6,14,2479013.97524144,6304110.296798599
22,1,2,2,6,11,2241121.33231231,6842654.77080546
10,0,0,1,3,4,1271365.49722503,3342197.38676941
24,4,0,2,6,12,2152528.22616706,8428934.09495027
37,0,2,0,3,5,1385448.22674269,2339421.32457336
22,1,2,0,2,5,1387208.29774803,5304327.13301337
15,6,2,2,5,15,2848708.05779356,12381966.688214399
29,5,3,2,6,16,2308437.57469489,5003281.03991488
31,0,3,2,7,12,2319477.38277652,7242474.50253479
13,3,1,0,3,7,1746796.16884162,5752383.54565854
37,6,0,0,3,9,1790396.49179985,4386386.66282502
39,5,1,0,2,8,2098245.63722115,5399168.66168848
15,4,0,0,7,11,1921720.42507344,6728677.80965951
30,2,2,2,0,6,1154384.30868412,3510035.33437491
14,2,3,2,1,8,1862991.14886668,8324301.09564722
11,4,3,0,1,8,2334372.2886646,9858089.82170247
31,6,0,1,1,8,1919326.57352198,7320632.94055651
32,3,3,2,5,13,2427791.49669772,7511454.02881375
12,6,3,2,5,16,2927482.0384044,10191188.7352407
13,3,0,0,6,9,1865234.75331768,9223541.1224514
25,3,1,2,4,10,1713617.42120797,4654075.83370079
18,2,2,1,5,10,1764230.31637518,6377413.36216669
40,3,3,1,0,7,1844060.20297644,2668953.99836936
34,3,1,2,5,11,1679353.04780317,7768481.54618481
30,2,1,1,7,11,2151467.61053927,4462787.05652604
36,6,0,0,4,10,2031975.16141252,5937883.28236662
10,2,0,0,5,7,1672050.12936356,4222141.85665517
29,3,2,0,1,6,1843552.35575476,7168581.02829868
26,0,0,1,1,2,1084340.22730042,4048747.82625875
25,3,0,0,4,7,1892122.55432338,5983304.10082748
38,2,1,0,0,3,1482891.63996677,2919771.28668574
28,4,3,0,7,14,3175328.02045575,6847213.46226779
19,5,0,1,4,10,2018610.2407733998,3602329.13644283
10,0,3,0,0,3,1374474.00517557,4453779.22579738
38,4,1,1,0,6,2088015.13461459,5001799.26015836
17,4,1,1,1,7,1948099.55799186,5266824.56831817
28,6,2,0,6,14,2230585.28547186,5892090.28714325
14,4,2,1,3,10,1876783.84941434,8375347.43260005
25,1,1,0,5,7,1893506.77867979,5872728.79145142
32,0,0,2,4,6,1588649.85947178,3973496.42437628
20,0,3,0,6,9,1992533.28779939,7587619.45651043
20,5,0,0,7,12,1875021.5952233002,4412437.70619782
33,0,2,0,0,2,1075212.12780009,2591435.51306321
30,1,2,1,7,11,1999319.74981968,7033815.49605576
18,3,2,1,1,7,1619652.44259658,7019451.15755505
39,0,0,2,4,6,1270864.26344107,6455559.66600843
14,1,2,1,2,6,2085004.9235095002,5067267.85193075
37,5,3,2,7,17,3470916.40928876,4013750.65294089
16,4,0,2,3,9,2060571.480662,4326771.23951885
34,5,0,1,7,13,2533699.09953856,4476336.95238094
16,6,2,1,4,13,1935212.01147713,7375761.46867859
16,3,3,0,7,13,2222690.20951853,7538447.04136282
28,2,1,2,4,9,2242395.70905853,4176088.95347247
38,3,3,0,1,7,1580835.69479088,3955015.1476293
32,4,0,2,4,10,1991968.0820265,8068964.22983317
21,6,3,0,6,15,2788640.27907562,7531643.95193936
34,5,1,0,2,8,1452395.226656,7803934.42780599
38,5,2,2,3,12,2031510.28058297,5225340.79720576
14,1,0,1,6,8,1480828.11616469,5623545.29973448
18,6,2,2,5,15,2415754.82497975,3385740.60018679
14,1,3,1,7,12,2502009.72397608,7050952.92017325
24,2,2,2,1,7,1617517.76375122,5605187.57666797
14,0,3,1,2,6,1845514.73994575,4845713.49896661
34,3,3,2,0,8,1571734.01153867,4931521.51360684
34,3,2,2,3,10,1889447.23952962,7392498.93797911
17,2,0,1,1,4,1705981.37823607,2968159.48740059
22,5,3,1,4,13,2575495.72650599,6190511.30255513
29,2,0,1,2,5,1905109.65094484,4661619.48495803
11,6,2,2,1,11,2062222.75947747,8627842.98493294
16,0,1,1,6,8,1823841.50619891,3522837.04968273
11,4,3,2,3,12,2119140.95603021,6609995.23204971
13,0,3,2,3,8,2178844.59516984,6033471.93987231
15,1,0,1,6,8,2127955.40249844,5845490.8094602
31,1,0,1,0,2,1218452.41328488,4502996.40569189
14,5,0,1,5,11,1966513.53448839,8017031.48517333
19,2,1,0,3,6,1296588.08617245,4685141.68829595
38,4,2,1,3,10,2109915.84891115,6817218.40608431
30,3,1,0,4,8,1620783.04908511,5928179.41489136
37,3,1,0,0,4,1203014.50771858,5706775.80406677
26,2,1,0,5,8,1708351.90172728,6392852.90263083
18,6,1,1,1,9,2114681.31006478,5712724.9791162005
20,4,2,1,4,11,1587525.17867625,7626263.93203174
14,3,0,1,0,4,1511066.88957216,4855006.805300401
26,4,1,2,7,14,2634557.12146869,5593163.75229067
12,3,3,0,4,10,2078904.78360406,5989543.67873272
23,2,2,0,4,8,1917096.07586736,7329908.29061237
13,1,1,2,3,7,1558223.43093896,3366534.83093091
25,4,1,1,7,13,2695709.12171136,4123677.29974211
20,5,3,0,1,9,1356008.381895,3012289.27961818
11,5,2,1,1,9,2011272.0111321,8419768.77107786
38,1,1,2,0,4,1434411.08220476,4735019.88720618
40,4,1,1,4,10,2044301.8177355,5221849.53455928
17,4,3,1,7,15,2601162.39201273,9378187.12358676
22,1,1,0,0,2,1427802.38525114,1561664.83119186
27,0,1,1,7,9,2140932.18405811,6392251.70121764
17,5,1,2,7,15,2729139.15419127,6530855.54210541
29,4,0,0,1,5,1459842.67205798,2360824.23657765
23,4,1,0,1,6,1122464.50537558,1595556.23434445
23,3,1,1,6,11,1706159.00100248,7301286.34202022
28,2,1,2,2,7,1373716.7796386,4427840.71945232
21,3,3,2,1,9,1567364.17801808,7076230.17984852
30,4,0,1,5,10,2078119.73540716,5682003.29311195
34,5,3,1,7,16,1589396.35030987,7336491.08582169
30,2,1,2,4,9,2168554.1379251997,10008033.919391198
22,3,3,0,0,6,1892531.31292166,5175781.59113769
10,5,2,0,1,8,1782257.2939382,3281114.78677717
33,2,0,1,4,7,2013298.76621532,3777077.1772752
40,3,2,1,6,12,2465886.95394975,4174785.52455224
36,6,3,2,4,15,2345019.21785059,4686938.21881105
13,4,0,1,5,10,1764818.54393607,6987344.78647492
21,4,3,1,0,8,1969889.85577242,3933617.33506996
13,4,0,0,1,5,1288852.44311155,6692404.73968533
18,6,2,2,4,14,2796359.53541095,9673518.01354246
40,5,2,1,6,14,2262243.25268861,5894288.98232667
23,3,2,1,5,11,2455442.75399168,6626507.12181397
21,0,0,1,4,5,1426100.00960305,4116131.54014936
16,6,0,1,4,11,2427369.87693029,5905057.27273173
34,6,1,1,1,9,1757824.65708764,6939725.92049662
26,2,0,0,6,8,1649451.96605764,7266711.28220877
38,4,1,0,7,12,2433644.93612591,6138512.639382401
20,1,3,1,1,6,1639419.42254963,5853697.20273359
20,3,2,0,0,5,1226481.36478206,5608230.90427044
32,6,2,0,6,14,2020526.84339124,7781152.32670014
32,0,2,0,6,8,1602074.77757236,6030474.68356762
32,0,0,0,5,5,2039244.66891825,5172644.25902127
19,3,1,2,1,7,1813713.6739766998,5085704.449859099
25,4,2,1,2,9,2710750.77660751,3577100.80719161
11,2,3,1,4,10,1782282.42691287,4137664.61951409
12,2,3,2,7,14,2955843.6690322002,6590376.08521007
30,4,0,1,7,12,2226731.1739481003,7197256.87439635
16,4,1,1,0,6,1400457.23717146,2360956.41564078
37,2,0,1,5,8,1379586.53621351,4754189.40843029
18,5,1,0,5,11,2291791.4120660997,5602726.51857157
29,6,2,1,3,12,2646685.70106592,6822304.58834264
21,0,0,2,1,3,1237874.4280251998,5121290.37188443
10,5,1,2,4,12,2220861.27732439,6842493.11462067
21,3,0,1,3,7,1823935.65856085,7843026.26343023
32,3,1,1,6,11,1730901.78429534,6905520.90317258
21,3,0,0,3,6,1655716.2716153,5634614.70829844
21,3,3,0,5,11,2229074.6502962997,8209018.07937388
37,1,1,2,0,4,1255861.00695135,7734682.38425956
24,6,2,2,5,15,2278530.00113346,3809067.80535143
33,5,0,0,0,5,1444835.16520036,7640299.7986269
36,1,1,1,6,9,2281621.89216037,7106746.04010642
31,6,2,2,3,13,2609680.7089907,3350423.52014571
14,2,1,1,4,8,2581957.76325064,4236267.26093958
34,1,3,1,1,6,1782438.74252218,5287256.62454649
26,4,2,1,6,13,2728260.08568076,3801835.6837859
14,1,1,1,4,7,1724937.30375022,5832168.89653718
30,1,3,0,5,9,1902202.2895887,3150960.79273507
20,0,0,0,5,5,1362659.79288794,3855949.26313559
36,5,1,2,1,9,1751637.47873571,5404471.00201464
15,5,1,0,7,13,2094801.14358656,6701862.78567445
35,1,3,2,4,10,2364468.52604036,6493934.87716996
23,3,3,2,5,13,2777332.16083458,5412800.25609991
38,4,0,2,4,10,2278691.10178936,7615954.07044917
24,6,0,2,1,9,2015835.66946504,2102325.09217087
18,3,3,0,4,10,1822113.98633847,6621966.79800509
14,6,0,1,3,10,1545314.75826639,6452341.62636731
33,0,1,1,3,5,1559327.73850932,2361424.61587302
29,0,2,0,0,2,1422648.2600566999,3808998.40654761
35,4,3,0,3,10,2130265.41669552,6870236.60034705
34,1,2,2,6,11,2368946.3984363,4871018.4861451
30,5,3,1,4,13,2064606.0017082,5826209.91760867
19,2,0,2,4,8,1409657.93769569,5949968.01376955
10,6,2,2,2,12,2924826.14889745,5382427.948782
30,0,1,0,2,3,1730001.02762728,4543726.81859449
14,3,1,2,1,7,1610187.65242434,7644253.42409111
25,6,0,0,4,10,2392737.66322297,5129730.05329597
24,1,0,2,5,8,1649438.42339878,5784553.73118489
31,6,3,0,5,14,1861618.73977233,7236658.91990247
38,3,1,2,6,12,2378765.92921601,5688901.49130666
17,3,1,0,5,9,1998132.72223954,4601301.55647461
23,3,3,0,2,8,2011868.02736849,4881774.6132134
31,3,1,0,2,6,1483889.56071158,5789128.51556721
13,1,0,2,2,5,1649893.63109545,1566062.55901256
36,2,1,1,0,4,1273471.4034442,4441548.37280746
31,6,0,1,5,12,2966117.12120214,8048022.26294591
31,3,0,2,2,7,1879708.97690575,4344466.56176212
11,4,0,0,6,10,1943178.46075256,7435473.94648094
14,0,0,2,4,6,1690042.51554428,5118122.78940731
19,3,3,1,1,8,1720678.74960851,5340302.45222561
32,3,0,0,4,7,1844081.77486482,5983225.03083708
13,1,1,0,0,2,1143255.30138252,1143255.30138252
29,5,2,0,1,8,1480930.20516969,4363768.72176655
15,6,2,2,4,14,2323191.44391779,6735861.36052139
16,3,0,0,5,8,1303671.63165657,5151758.76748146
18,1,0,0,3,4,1251829.97177962,3110888.21846633
13,2,3,1,0,6,1707518.25551005,4342695.64070101
21,5,2,1,6,14,2632426.04773375,6774645.49881968
35,5,2,2,5,14,2044429.19732232,8115564.41435559
26,5,1,2,3,11,2157676.80595284,6819663.81733796
31,2,0,0,6,8,1408054.84087017,6338827.90908395
25,2,0,2,4,8,2146885.34733234,3240483.58394051
39,4,3,1,0,8,2357638.97300674,4630106.26324062
10,2,1,1,4,8,1871346.98891657,5391312.53873586
19,4,1,0,4,9,1786725.3318557,6978847.14833039
27,5,0,1,7,13,1582804.21781425,6724210.64627418
15,1,3,2,2,8,2071793.27497283,3491000.86050006
17,1,2,2,6,11,2027620.43743077,3576226.94891607
13,3,3,1,5,12,1358388.06400178,6889289.32426289
36,3,0,1,1,5,1529640.42074274,3095279.79338607
15,1,1,1,1,4,1307988.64606621,3532908.32025865
29,2,3,0,1,6,1519991.98314799,5622123.57325435
19,0,2,0,6,8,2359608.84053445,4813304.567482701
18,6,3,1,4,14,2803582.69208308,9246659.05312276
28,0,0,2,3,5,1832509.40070578,4655410.59491914
21,6,1,1,7,15,2483268.48334091,10636512.3544262
12,6,1,0,5,12,3010928.30124894,6788902.18748283
38,4,0,2,5,11,2053774.40064682,2170764.79556572
17,6,2,2,6,16,3343357.48773863,6198688.72116088
13,3,3,1,7,14,2547496.61799041,7921234.89029801
11,5,0,2,6,13,2691269.00850357,3624582.24590425
30,1,0,1,7,9,2410196.68339368,6789557.1729589
15,2,3,2,3,10,2093766.91434271,6846189.90369006
23,5,3,2,4,14,2479016.7539332,9134432.26063756
17,3,1,1,6,11,1875065.7845332,5311750.88533507
14,0,2,2,5,9,1784208.79916224,9119690.53554217
22,3,1,0,4,8,1348185.72616441,4489790.20059445
15,6,2,0,5,13,2130158.10794108,8146816.91533732
37,6,1,1,3,11,2055489.05322446,5621182.71742973
10,5,2,1,1,9,1842230.49697183,7243834.448721499
25,5,1,1,2,9,1843467.99834428,3562642.78231503
12,4,3,1,7,15,2048251.03371505,8221265.32534745
32,6,1,0,1,8,1665668.90585624,5052659.1691405
29,3,2,0,1,6,1568578.19252341,4265261.58685186
29,1,2,1,5,9,2328562.26641773,3258650.25263714
30,5,3,2,3,13,2160960.25033859,4617131.97962446
31,3,3,2,6,14,2426685.61523553,6536122.57820464
38,2,2,2,1,7,1491606.14415952,6084307.90972392
16,0,0,1,0,1,1324275.79617373,4590882.97661878
25,4,1,0,4,9,1679927.07091153,2573295.6336633
21,2,0,2,3,7,1701615.08171939,6671582.2051423
24,0,2,0,3,5,1478647.25046045,3254450.92437357
18,1,1,2,4,8,2108846.23115457,6915971.60215916
28,0,0,1,2,3,1692314.0334571002,3928480.20192224
36,1,1,1,4,7,1571770.34851407,5136396.98045378
31,3,3,1,2,9,1695882.94730841,2238211.19736848
30,3,0,2,1,6,1828012.71555081,3934643.90669062
23,6,0,0,0,6,1890977.06095721,5148617.54011459
24,2,1,0,7,10,1393346.08192865,6498014.02199887
22,5,0,1,5,11,2127197.69826511,8023508.59500531
19,0,2,0,6,8,2162781.07328099,5271946.54336385
27,5,0,2,6,13,2464134.0417782995,4719809.3175777
12,1,2,0,3,6,2275686.09573166,5604406.38440371
23,4,0,0,0,4,1316511.20265824,2707364.6090355
40,4,1,0,7,12,2436969.55715186,3829117.59204575
30,2,1,1,4,8,1706421.70590123,5283518.06254035
16,4,1,2,5,12,1929005.23259279,6252820.16411825
35,1,0,2,0,3,1456733.94166038,3936363.07827166
22,3,2,2,5,12,2721997.66134074,8755166.39530554
21,2,0,2,3,7,1552286.2928823,3093446.96566826
27,6,2,0,1,9,1996167.17712429,3803475.33813568
37,2,3,2,1,8,1702390.53738298,5901185.8759228
30,4,0,1,3,8,1605012.59119446,6259110.67658428
37,1,0,1,3,5,1552787.22166651,4128610.81876492
35,1,1,2,2,6,1170351.91866871,4815751.50766721
36,2,2,2,2,8,1365198.99080375,7483729.82294587
28,1,0,0,4,5,1737291.01643902,5667913.74533956
11,3,1,1,2,7,1777502.83214955,6337855.19307285
30,2,0,1,3,6,1376948.1453758,3842286.89524337
18,6,0,2,3,11,2736674.13646624,6019040.75499631
29,1,0,0,0,1,856959.836224678,5788896.80579504
35,2,3,1,4,10,1654746.88872666,3748552.09822025
38,5,1,2,2,10,2513319.32290466,5562999.01689031
13,6,3,2,7,18,2357553.96358034,13823359.3776811
22,1,0,2,7,10,2140028.36252986,6155302.69636256
17,3,0,0,7,10,2504727.94671102,9677690.56053057
15,3,2,2,3,10,2205477.48538264,6169831.72806339
40,5,2,1,0,8,1639551.61738851,4683876.28434969
36,2,0,2,4,8,2009195.81395319,3929563.25957501
11,6,1,0,6,13,2950531.72429589,4799229.4526855005
33,3,2,1,2,8,1446271.23135991,5960739.562010501
16,2,3,2,5,12,2694028.51588124,4955046.10177508
38,2,0,0,7,9,1530911.51344124,5484565.89170351
29,3,3,2,1,9,1741232.50519598,5055210.43887169
26,0,0,1,1,2,809558.004000918,3678042.55443174
20,1,3,1,4,9,2129031.89832256,7953740.59683552
37,3,1,2,2,8,1594986.5740148998,2924725.50632014
38,5,0,2,5,12,2189831.64655017,7861265.05591009
20,6,0,0,6,12,2628685.04616639,7718754.75572279
36,4,2,0,7,13,1832369.9674425,4036161.67617852
35,0,0,0,4,4,1337676.80177546,5075666.19487535
14,1,2,2,3,8,1808490.69759943,2540357.42586651
31,4,0,2,3,9,2049776.12124713,5789474.70326836
33,3,2,0,7,12,1778322.48103269,6300410.27701926
37,2,2,1,2,7,1816976.09978656,5247978.89922997
38,0,2,0,3,5,1437257.95642399,5172778.56031359
18,3,0,0,1,4,1015284.57337247,3887944.34923321
35,5,1,0,7,13,2270551.48924743,6671715.0570642
36,3,3,2,6,14,2862922.94853073,9569491.14575182
29,2,2,2,3,9,2162255.5033532,8677580.30556616
17,0,1,2,4,7,2055612.77872398,4490203.11423079
22,5,3,2,6,16,3503167.43444184,4766294.64110588
39,0,2,2,7,11,1292164.41227345,5710718.44124071
15,4,0,1,1,6,1614353.66688825,3454335.72522949
21,6,3,1,2,12,1979648.10152372,5520618.93099436
40,5,2,2,7,16,2268064.89719402,5397508.89678639
26,3,2,1,4,10,2146220.62086235,9881995.14344271
13,3,0,2,7,12,1769826.5729845,8099675.95285827
13,6,1,0,1,8,1521263.27142769,7201106.33233527
25,1,1,0,0,2,1170380.83292211,1747749.19848532
17,4,1,1,2,8,1899597.74912428,3142907.26944592
35,2,1,0,4,7,1531525.02499942,4720833.89739363
36,3,0,2,1,6,1559681.23150402,6373169.96844955
20,1,0,1,2,4,1690873.83398221,5617432.96209985
32,4,0,1,7,12,2412730.33883466,7460064.42151938
27,2,2,1,6,11,2584707.90173443,6108437.45978225
31,1,0,2,4,7,2274292.44102233,7007185.46838651
18,5,1,1,0,7,1862372.40581515,3593135.5634318
21,2,2,1,7,12,2445443.20816851,6507902.4200403
38,0,2,0,6,8,2532001.84264858,5412725.37581288
18,3,0,1,4,8,2026609.07501933,5381360.78871042
17,5,1,1,2,9,1499231.15569293,6696052.71992151
24,0,1,2,5,8,1779614.64714048,5987061.92824604
34,0,0,0,3,3,1427229.67213411,4922708.90183241
15,6,0,1,0,7,1869036.13515812,5872064.86413696
36,5,3,0,6,14,2841156.4997774,8884820.2765643
35,6,0,1,5,12,1928018.283469,9461121.7844192
39,2,1,1,0,4,1429977.48940824,3646267.97275541
21,2,3,2,7,14,2500050.06170795,10642615.393109199
10,0,2,0,4,6,1432259.55884994,5486183.41936664
23,3,0,1,3,7,2024724.76055426,4192155.32857436
32,0,3,0,7,10,2128406.58253063,5792657.85495891
38,3,3,1,1,8,2090891.1679406003,4328893.57191792
28,5,1,0,3,9,2347678.33676683,6762146.20329824
21,6,2,2,1,11,1823890.05356182,5992708.57858693
26,3,2,0,2,7,1638754.52613459,4397959.81293417
38,3,3,2,0,8,1189000.63872469,2967868.66796507
22,4,1,1,3,9,1845094.5313159002,4261823.40533737
40,0,3,0,2,5,1595036.78743174,3789761.19676329
35,1,0,2,5,8,1781063.0787235,7773706.18123329
29,6,2,0,3,11,2651757.48114411,7259815.85831725
36,1,2,0,0,3,1636871.02725131,4752360.63634285
32,3,3,2,5,13,1494101.36598819,4319437.68816831
13,2,1,0,2,5,1414648.68183751,2727247.16936598
12,1,1,2,5,9,2121581.9507155,6899754.35552583
13,6,3,0,3,12,2259679.92847288,7036310.19758837
38,5,2,2,4,13,2303345.99716806,5595973.34466272
12,6,2,0,7,15,3483677.05436295,6507068.52497117
19,5,0,0,0,5,1607346.18588725,5728975.08716771
31,1,0,0,2,3,1288263.33858084,3945460.01930138
30,2,0,2,1,5,1819727.36921924,6709690.41189415
34,6,3,0,3,12,1825199.8014369998,5764334.51586599
21,3,1,1,5,10,2321593.99226851,7124029.17162174
10,0,2,2,6,10,1807353.5241375999,4848772.70992174
29,6,3,0,6,15,2677893.91181656,10221211.3996199
22,6,3,1,2,12,1709994.18912212,5042384.77733544
28,3,1,0,2,6,1657654.8169295,4638172.84032998
35,4,0,2,6,12,1906738.99669478,10040824.0908385
25,1,2,0,2,5,1554756.23387843,3165252.92207123
31,4,0,2,6,12,2020854.71301221,2293243.36886417
16,3,0,1,1,5,1914604.3249321,2998185.98244562
19,6,1,2,4,13,2521387.38820451,7931975.36456637
30,1,0,1,6,8,1747721.29760936,7629484.1286795
30,6,1,1,4,12,1817458.02578781,7804277.53229192
31,4,2,0,1,7,2186157.00620996,4436357.80001776
24,2,0,0,7,9,1909073.34104256,5672182.41886414
37,0,1,1,6,8,1760807.63907608,6259191.00379272
13,3,0,2,7,12,2196816.86010742,6739799.32216023
23,6,1,2,4,13,2312199.91547034,5605359.13602688
32,2,1,0,3,6,1783768.59940571,3528110.05029163
11,3,3,1,0,7,1784003.89785538,4458134.40349327
20,4,3,2,6,15,2703133.18474307,5726615.89422235
12,5,0,0,1,6,1158384.86828701,5236714.02035606
25,5,1,2,5,13,1815011.45835357,6011625.02291548
39,1,1,1,1,4,892745.0733306521,3249800.08515427
14,4,2,1,5,12,2221469.30926623,3468367.56447153
32,6,0,1,7,14,2422705.41759818,10642826.0840055
33,6,3,2,7,18,3245677.65046109,8898148.04105324
12,2,1,2,2,7,1746468.99349751,6052269.76410429
24,5,0,0,2,7,1754050.58843635,3981344.19380687
30,0,1,0,5,6,1475750.83593467,5351124.94785728
29,2,2,0,1,5,1791648.66131579,4222720.9636685
28,1,3,1,1,6,1888535.49258626,3799907.48038805
35,4,0,1,1,6,1526757.17056208,6022060.76026783
36,6,0,0,5,11,2137912.46643818,8380662.09537173
40,2,2,0,3,7,1418428.07680379,4992577.81519171
26,2,1,2,2,7,1466678.8026271001,7811287.77072765
29,2,0,2,3,7,2188494.36132848,5909611.37200235
27,2,2,0,0,4,1645892.58008541,2145444.75137133
39,4,1,1,5,11,2362845.18785352,7128078.07108095
10,3,0,2,7,12,2209549.37737319,2611484.69416449
15,6,3,2,1,12,2086942.89173854,3628310.11337813
29,0,1,2,2,5,1445817.65606082,4280492.35683016
22,5,2,0,2,9,1859973.85608527,6288188.41302151
25,5,1,1,7,14,2730606.34432872,8688750.04220264
12,2,0,0,1,3,1127599.87166188,3423476.5325975
14,2,3,2,6,13,2274204.85082705,8176457.02243861
31,0,2,0,0,2,1110988.76455935,4827216.37933059
17,1,0,2,6,9,2030893.74332404,6531860.030582599
21,3,3,2,7,15,2556066.03265683,8615172.19299796
37,6,1,0,2,9,1702891.20776825,6093450.87279909
24,4,3,2,5,14,1781022.1474345,10252964.5288215
28,4,1,1,3,9,1758233.58746931,5674413.00437396
16,3,3,2,5,13,1970084.57009468,8469678.89756816
20,3,3,2,0,8,1674559.99017732,5283481.075454
21,5,2,2,2,11,2054717.25262317,6474506.4955563
11,4,3,2,7,16,2931155.20166278,9157409.52871942
11,6,1,1,3,11,2271551.55268467,5114790.69257892
23,2,1,1,2,6,1869391.1561758,2598004.50689596
10,4,1,2,1,8,1482880.07067246,4985810.85808131
31,2,1,2,5,10,1998501.33536412,9044518.905706199
40,3,1,0,0,4,1608233.93820873,3496984.86918812
36,1,1,2,0,4,1452789.31737434,4610416.14484358
34,3,3,0,2,8,2130571.02926835,5020560.57240056
13,6,3,1,0,10,2164799.78358788,8110691.86921589
26,2,2,1,5,10,2352477.11559066,7625181.41262547
26,5,2,2,3,12,2331026.00330443,6146188.99819322
29,6,1,2,5,14,2363187.50701491,9418526.85509698
33,4,0,0,3,7,1692797.9125271002,5653340.84297292
31,1,3,2,5,11,2392117.46870942,7251790.08625329
28,1,0,2,1,4,1461234.27018718,4400693.48507505
16,1,2,1,6,10,1978416.67907766,7632687.62345553
25,4,3,1,1,9,2301788.58531287,4560891.95892793
16,1,0,2,6,9,1649442.52648748,6628311.57556519
20,2,2,0,1,5,1736854.56323436,6159212.38135497
12,0,1,0,2,3,1541962.33439669,4812971.90577127
16,4,3,0,5,12,1887482.88097161,5595100.87651101
32,1,2,1,7,11,2404450.02639588,722402.53013554
26,2,2,0,2,6,1399570.39264586,4256423.89294251
33,3,3,2,4,12,1404385.54338372,8842181.40751227
26,6,0,2,2,10,2269631.85104193,6044020.43575142
35,4,1,1,4,10,1656263.87388954,3689291.43915559
24,4,0,2,0,6,1692817.57317019,4430335.21948066
38,3,2,2,1,8,1786190.12718122,4238551.03092103
10,1,3,2,2,8,2081381.38155678,5605772.93536644
12,5,2,1,4,12,2031354.99775576,6756139.34236522
32,1,3,2,1,7,1841521.10721075,3609900.27837944
19,4,0,2,4,10,1995799.66998551,4394651.16345382
32,0,1,1,6,8,1833145.92383302,5582858.42327228
40,3,3,1,4,11,1907200.68949774,6398383.93950207
27,2,1,2,5,10,1998485.27476614,5382808.13728429
31,3,1,0,0,4,1413079.55501157,5909984.64022375
24,5,3,1,6,15,2594792.34490361,5971607.32662078
10,0,0,0,2,2,1007771.96377071,3877163.89870087
22,1,0,1,2,4,1258000.98994997,5021410.6664337
29,4,0,0,5,9,2059856.32128323,4112686.80133093
27,3,2,1,4,10,1967824.38888193,7107203.04974575
17,5,2,0,1,8,1762084.02339265,5336070.88997895
31,5,0,2,0,7,1512664.97385241,3851237.01746703
13,4,1,1,7,13,1986168.17274218,4922313.12439364
29,4,2,0,6,12,2070507.20180164,7942790.11598712
36,6,2,1,2,11,2307002.40675582,7684903.35839199
26,4,3,0,4,11,2608101.65358927,8465724.00330041
14,6,3,2,5,16,3525087.33568053,5607811.81553994
15,6,2,2,2,12,1981377.83481224,5479899.793608701
16,4,1,2,7,14,1922780.17362489,10468254.3707013
29,4,0,2,2,8,2045426.87081891,4895076.57626482
11,4,0,2,4,10,2130312.50344437,2767921.8078155
24,1,0,0,3,4,1363377.91926551,4438477.25959868
38,0,2,0,0,2,1116782.00187496,3517549.54520251
11,0,0,0,1,1,981220.599072385,6370157.4549244
39,1,1,2,4,8,1532612.40538906,3995100.57969952
21,6,1,2,2,11,1933068.21325336,4634145.86482085
14,5,1,0,6,12,2095934.62971381,9078562.11422198
16,2,3,0,4,9,2109800.2498781,7358097.56082907
36,1,2,1,3,7,2118066.09812461,6111714.72293503
10,2,1,1,2,6,2270956.67428268,4936601.43854387
22,2,1,0,7,10,1488365.35689062,7070147.45781643
25,3,2,1,1,7,1819061.92103596,5829558.92938573
10,1,2,1,1,5,1697631.97175362,5697277.01197981
29,4,1,1,5,11,2554016.00875105,6636452.03019983
18,3,3,1,7,14,2370698.58609328,7190747.06404046
30,3,2,1,1,7,1982431.25392842,7897545.08014389
31,6,0,2,2,10,2031545.39492132,6544960.81165473
34,0,1,2,6,9,2018475.33745068,6380689.70556444
35,0,0,2,0,2,1244050.64889825,4385949.48423326
12,1,3,1,3,8,2035523.50358149,6817886.92329844
28,6,3,0,7,16,3105289.04187151,8606071.30345904
20,5,1,2,6,14,2049201.21109445,5484770.29604823
37,5,3,2,5,15,2225261.93007692,2353651.01385914
39,3,0,1,2,6,1797272.21524685,4525522.18514008
32,5,2,1,4,12,2064530.55714592,6685262.86317277
27,3,1,1,3,8,2355354.40734405,4152055.42517981
24,1,3,1,3,8,1623734.42943088,7457442.35391732
21,5,2,0,3,10,2121615.9563265,6495813.0325047
28,1,0,0,0,1,868227.689191156,6145200.36516624
40,4,0,2,6,12,2538023.43444698,6285814.71626334
32,0,3,1,7,11,2122589.32957929,5993933.41843942
28,0,0,1,0,1,1058952.82284727,3034624.19190506
23,5,0,2,5,12,1926290.16481999,3186189.60546742
20,1,3,0,4,8,1680116.19292944,3461744.41601296
11,5,3,0,4,12,2327292.14405197,3900316.19935936
28,6,0,2,0,8,1660259.76746055,5258254.65491256
19,4,2,2,6,14,2779570.41925147,7788632.63238973
11,4,3,2,6,15,2555935.00776689,4559467.42047058
21,2,1,1,2,6,1707325.2858854,2630189.69925652
33,2,0,0,0,2,1275245.73420764,5539833.60154646
15,3,0,1,0,4,1498208.72383932,5623049.13190219
20,6,3,0,5,14,2057336.27872874,9718987.38221432
40,5,2,2,6,15,3126191.63743111,10078609.127228
25,6,3,1,7,17,2137865.32063709,11954328.7475719
40,0,0,0,4,4,1506698.1682183999,5194015.02809333
29,1,3,1,0,5,1197307.5283706998,4180426.62104694
29,6,2,0,1,9,1985729.46579669,5901196.53523036
38,2,1,0,2,5,1258426.92734878,5573961.67121252
38,3,2,2,4,11,2161274.6126266,3633911.79537163
33,3,3,1,0,7,1994611.0603151,6364474.17629923
36,4,0,0,7,11,2286068.65099137,5465653.28464787
17,4,0,0,7,11,2095653.76059323,4783838.02113497
20,6,0,2,4,12,2771692.82088557,6893266.58880643
16,5,1,1,5,12,2415362.37298719,6840969.63643784
13,4,3,2,1,10,2730602.08647162,9171624.66757595
30,6,2,0,7,15,2611995.51059993,5987513.45764472
26,5,1,1,6,13,2272545.70608779,6515096.48967395
13,4,0,1,1,6,1780506.41088136,2278756.58010939
31,6,2,1,1,10,3043447.26075764,5045158.27236469
15,0,0,0,5,5,1390262.9114811001,5403113.04449153
37,6,0,2,3,11,2427085.72022065,4102451.3879393996
36,5,3,2,0,10,2189046.03389564,6094975.99037091
10,3,2,2,6,13,2808852.09731727,5512796.72027802
27,5,2,1,6,14,3176249.68521861,9002918.87016686
12,1,0,1,4,6,1283779.75578727,3686776.4250249
23,4,3,1,3,11,1753953.19016058,7282616.65383091
15,1,2,0,7,10,2491818.49761345,5516224.19290663
27,5,1,1,0,7,1753844.84882986,4470947.57853067
22,1,0,0,6,7,1665061.58720967,5033445.41217012
34,6,2,2,1,11,2302477.98671432,7178443.89197941
11,0,3,1,3,7,1546265.1131883,4201016.99459311
10,6,0,2,1,9,1813911.44239168,4379661.32879452
40,3,0,2,3,8,1797724.81314434,6953232.73119722
19,3,2,2,1,8,1772714.91067866,6302441.79437747
37,1,1,2,2,6,1570957.14368854,6017018.88227806
13,3,1,2,3,9,2037970.34387928,10599531.845806401
32,3,2,0,4,9,1669117.96236889,6210193.55222234
14,6,2,1,6,15,1748528.55339339,11100786.2301975
17,2,2,0,1,5,1558635.87480548,5482847.8419549
23,0,0,1,5,6,1583637.60076825,4048649.61667962
32,0,2,0,2,4,1036294.28053814,6172031.56246959
34,4,2,0,2,8,1869041.97060668,6538421.92493729
36,4,3,2,4,13,1733482.00811459,6977032.00515237
36,0,0,0,6,6,1580409.41680964,4229150.81173054
32,5,0,2,1,8,2016289.76537129,6657041.20385988
19,1,1,1,2,5,1624579.72232504,1141260.34375285
10,5,3,1,4,13,1624613.9670392,5111972.83848048
28,2,1,0,4,7,1680809.72680414,4748238.04149468
23,4,2,0,0,6,1699561.01234896,4030548.25087453
36,1,0,1,7,9,2187484.66769452,6521636.14932722
29,5,2,2,0,9,2421105.44284684,4447632.47955879
14,1,3,1,2,7,1670788.99920112,4264326.60780324
16,5,1,0,5,11,2151104.98680881,7987281.25262625
29,0,1,0,1,2,1105721.43934927,2199491.36332633
13,1,0,2,1,4,1522703.73149444,3670334.69201064
20,6,3,0,6,15,2298998.026305,5051023.63526837
11,3,1,0,4,8,2020272.02445184,5172097.32992297
28,4,2,2,6,14,2405184.22266048,8725161.07020442
12,5,3,1,1,10,2830073.25393406,3318670.54381545
34,6,1,2,5,14,2126031.57415336,7999696.78716061
16,2,3,1,6,12,2039967.24331548,7790378.55332339
11,1,1,0,7,9,1749821.8144088,4473994.99189657
20,5,0,1,6,12,2059041.2405888,4301786.40934388
34,2,3,1,0,6,2004882.78373715,4509401.21465969
29,5,1,0,2,8,2161277.51004867,7612720.59484849
26,0,0,2,1,3,1506371.76808484,4114303.06123383
30,3,2,2,2,9,2053474.10991222,5239613.24655341
21,2,1,2,6,11,1428650.55455534,8593575.36371622
24,5,3,1,2,11,2164535.84345039,3448446.76332717
17,3,2,1,5,11,1991847.11338489,6626263.79755695
39,1,0,0,3,4,1427688.68790076,4107826.32558899
31,0,3,1,4,8,2426357.28182228,3965854.53337556
21,6,1,1,6,14,1340682.63725521,10205716.442111699
18,6,3,0,6,15,2734226.2830142,12267829.324833501
19,0,2,2,4,8,1274308.97226455,6932519.56689972
37,4,0,1,6,11,2060645.13115765,5412982.50135934
22,0,3,0,2,5,1638541.24362848,3794064.22552254
17,0,2,0,0,2,1253842.06048588,2359679.03146145
39,1,2,1,3,7,1649216.06047743,7584512.51956449
30,3,0,1,3,7,1610773.73728752,1818525.91405795
10,5,3,1,3,12,3097650.99529857,6403479.15179211
31,3,1,1,0,5,1703797.13848069,1211430.63679295
30,5,2,0,2,9,1722518.73427165,6105194.70274277
19,0,1,0,7,8,1842370.12378952,4895350.79870925
20,2,2,1,7,12,2099925.54419535,8100293.66230778
21,3,3,0,7,13,2531778.53605846,9724683.98861601
34,4,0,0,4,8,2288318.84392893,5008238.12916871
35,1,3,1,1,6,1330930.49706981,3940114.5881567
10,5,1,1,3,10,1902846.78529705,3428288.21411269
36,4,0,0,2,6,1726578.34881619,2879716.11663485
38,5,1,1,1,8,1425497.00709621,4558138.7988592
32,6,3,2,2,13,1834370.66132401,8910848.58381855
39,4,2,1,6,13,2744104.48854547,7203462.464820099
31,2,2,0,2,6,1368878.14859068,7663186.15788025
31,2,3,1,6,12,1840084.04690996,3516625.73322886
34,2,2,0,1,5,1622081.80867779,5561666.42677164
17,1,3,0,6,10,1654688.59050124,3098387.01257125
25,6,3,0,5,14,2200506.86989837,8767615.99169687
25,1,1,0,3,5,913568.93845943,3293964.1088137003
13,2,1,2,7,12,2436865.54825286,7689806.5439789
26,4,2,0,4,10,1582541.1735432,3919540.45099031
19,5,3,0,0,8,1744818.3184271,2360276.53506826
14,6,1,2,3,12,1515670.07996189,3570780.44139539
23,4,0,0,3,7,1709561.49597357,4658433.91682616
22,0,1,0,6,7,1565094.68339068,3515709.93319535
20,5,0,2,4,11,1841989.51521289,5371390.27155724
11,1,1,0,4,6,1357486.29513076,3793212.11591265
19,2,3,2,3,10,2140257.19826751,3373877.16025067
11,2,2,2,0,6,2056974.13633262,6181097.56336416
26,6,2,1,7,16,2467283.3607107997,6635182.44493694
35,0,3,2,2,7,1557562.31011882,5204032.95549786
32,1,1,2,3,7,1886333.16327806,2991286.68768482
17,4,0,1,5,10,2007689.50316232,9599950.25322175
39,6,1,2,4,13,1817152.42319846,9444309.10784178
14,4,2,0,3,9,1762679.56161733,5900880.74991406
14,0,3,0,0,3,946657.377102285,3279224.4237313
11,1,1,1,4,7,1428896.35610332,3497520.71977985
23,1,3,1,7,12,1979908.60375276,6567009.92923806
38,3,2,2,4,11,2655759.95545342,6245161.79169206
37,3,1,0,5,9,2080274.60816286,6168531.38745808
40,2,2,1,1,6,1810941.34908091,6005237.94658186
13,3,3,0,1,7,1622063.18114948,587393.519114632
35,1,3,1,2,7,1965905.70651363,5143621.53360177
22,6,1,0,5,12,1859444.5295736,4663817.98251127
22,1,1,0,3,5,1031388.59537726,6363416.43570977
33,6,2,1,4,13,2719713.80492648,8526242.46002341
37,5,2,2,3,12,2730452.58637376,6524606.6978618
28,1,1,0,1,3,1263822.99936067,4734229.26688199
32,6,1,1,6,14,2324574.23474033,10787216.688000802
25,4,0,0,6,10,1880605.02569429,5250406.46575422
12,5,3,1,7,16,2751521.84687071,3623265.30204409
25,5,2,1,5,13,2834995.96697295,7711227.63893268
28,3,2,1,6,12,2347208.73747617,5462602.08628427
39,6,0,0,3,9,2113169.72365455,5182942.57401485
29,6,3,1,2,12,2107176.59984797,3885599.3221050003
22,3,2,2,5,12,2105528.38898579,7046079.79231405
13,5,0,1,3,9,2289626.49469458,5031478.94814761
17,3,0,0,5,8,2035063.09268969,7084508.61985148
14,0,3,2,4,9,2458657.60586287,7910065.2134841
39,1,2,2,5,10,2075034.07034278,7730462.4828127
22,1,3,2,3,9,1946839.50859961,3995184.15440636
29,4,2,1,5,12,2581278.00293146,5616960.76260332
33,2,3,2,6,13,2109071.00609699,4591747.86319583
11,3,1,1,7,12,2577809.12140136,7338125.37952738
38,6,3,0,5,14,3018645.46054303,6806780.65418216
39,0,3,0,5,8,1743291.15710456,1603271.31638765
40,1,2,0,7,10,2613132.83996883,6537693.51134259
35,1,3,1,3,8,1897015.24179517,2764744.15497785
24,5,1,0,7,13,2230967.5877438,7394619.38990401
33,3,3,2,6,14,3693184.43121719,4689274.02144829
27,5,2,0,1,8,1843907.12250315,8117239.97602148
29,6,1,1,2,10,1809560.48341057,6571591.86067566
21,6,1,1,2,10,1914032.13891509,7708604.00041037
18,6,3,2,3,14,2418952.24161245,3525802.70480972
18,0,3,1,3,7,1370044.32778615,4605775.2167277
32,6,1,1,0,8,1902845.37522861,3730140.5362563
29,6,1,2,2,11,1897391.19998188,5726758.47326959
15,3,2,0,6,11,1809360.01756744,4766170.34441115
12,4,3,0,1,8,1734230.64774695,5164512.21370398
36,3,3,1,7,14,2926933.25786108,10327975.7093806
28,1,3,1,3,8,1765783.35076061,6229741.50975918
21,1,3,1,6,11,1762636.26850207,8495718.20739296
36,0,2,0,1,3,1426393.67633443,4396784.45180078
12,3,1,0,0,4,1657176.42156146,4376254.21689767
27,0,0,1,4,5,1540080.5805394,5993715.00614718
32,1,0,2,2,5,1814141.57604971,4016654.74831877
21,5,1,0,3,9,1897252.07859951,5863638.21130694
40,4,1,1,5,11,3131907.48637933,7947295.16496853
40,2,2,2,4,10,1410837.37234331,4851544.02418706
32,3,0,0,2,5,1575077.12230739,4103643.54638403
12,6,0,2,5,13,2916488.21837294,5489195.79964213
39,4,0,2,4,10,1929122.92567189,6345362.96771232
37,0,3,0,0,3,1357338.91307233,3699096.32043973
10,5,0,2,0,7,1732128.34921191,2793428.12695962
12,0,0,1,3,4,1429391.63428983,5348155.99505205
27,5,3,2,7,17,2956675.66800352,9424500.84252931
19,2,1,0,3,6,1877271.55918535,5951348.21119874
16,2,0,2,5,9,1989383.3575169998,6056650.56628647
16,6,3,2,6,17,3481957.97787951,7146291.02161249
36,5,3,2,5,15,3102262.35924162,10413693.8754007
14,6,0,0,3,9,2081290.31742281,3499515.99449258
18,3,1,0,7,11,2092711.42097733,5028378.58431244
22,2,3,0,2,7,1437097.33041761,2622413.48585821
21,5,1,2,2,10,1558462.43043934,3403091.81977009
11,3,0,2,3,8,2380568.86513981,5824395.85858878
19,2,2,1,0,5,1456606.56695762,4648993.92737245
16,0,2,1,6,9,2554924.96554608,2540448.94053642
23,0,0,2,2,4,1437933.307457,4522825.11923089
20,6,1,0,6,13,2651792.7504653,5277092.80726624
30,4,1,2,0,7,1964357.40834359,2478415.94692985
24,2,1,2,1,6,1647000.06573486,4928037.77227965
16,2,0,1,0,3,1132372.27625073,1338167.45333625
32,5,1,2,1,9,1935919.72917087,4462159.01946026
31,4,2,0,1,7,1964445.82481269,5459972.00363925
13,6,2,1,4,13,2140826.80233948,2922042.65698081
35,0,0,1,7,8,1972908.51300095,8207713.31768748
19,2,0,1,7,10,2333099.40513666,8276524.49321773
18,5,3,0,3,11,1806351.51303187,6506716.24276189
22,0,1,2,6,9,2193442.09354525,5779377.56894867
11,1,2,2,7,12,2411581.75506097,8090920.02665707
11,4,3,1,3,11,2053001.42219174,6320901.80169944
20,6,1,0,1,8,2255794.48298654,2937249.79166032
38,4,1,2,7,14,2743733.68595116,7456985.68037137
34,0,0,0,0,0,1100990.13475628,2587764.89002402
18,4,0,1,4,9,1630066.40736966,5609296.90664731
39,3,3,0,4,10,2184946.64961779,5412548.47025069
17,6,3,1,3,13,2424362.80599844,4650202.71698731
12,3,2,1,2,8,1705663.43957144,4565520.83436984
12,0,3,2,7,12,2535824.47727494,6079202.44843469
11,1,1,2,6,10,2212393.27176281,2332514.53112382
12,0,3,0,7,10,2469762.5837492994,4386738.17199797
38,2,1,2,1,6,1687225.35592869,5681114.65576008
35,5,3,2,5,15,2649933.99575199,7383031.35303238
23,2,3,0,1,6,1496380.44523368,4444199.15333584
19,5,0,2,5,12,2326530.02199759,8716701.08757538
32,0,1,1,4,6,1718759.94613929,6337417.36454664
18,5,1,1,0,7,1615905.632466,1401931.4684311
29,5,3,2,1,11,2120743.78218852,4109604.69927348
39,6,3,2,7,18,2403589.52497397,7665350.53985499
34,0,1,2,3,6,2047036.71821108,5565586.69860426
16,6,3,1,0,10,2224742.57553045,4608816.04581938
37,1,3,2,2,8,2083624.38243902,6221604.59179368
28,5,1,2,4,12,2252044.36570189,8081826.97819983
31,6,1,2,5,14,2511103.11482634,9341669.08823517
27,6,3,0,0,9,2034956.40582485,5785575.25761942
20,5,2,0,5,12,1786079.47062861,6460655.40651082
34,2,3,2,7,14,1963877.42710799,3963373.3844962004
38,4,3,2,7,16,2475227.93897615,10174975.5149877
38,6,3,0,1,10,2184365.3177536,6607445.89494143
33,6,1,2,2,11,1716305.33043591,5630341.33383901
10,6,3,2,3,14,2345010.00220626,5606365.24200492
23,1,1,0,7,9,1060948.37230786,5419881.80646933
17,5,0,2,1,8,1612093.93731883,8235130.26449024
20,5,2,0,7,14,2628287.70026527,13108805.9164832
27,1,1,2,2,6,1605665.10346749,4117048.45102774
23,4,1,1,4,10,2101261.7647043,5742621.79718905
29,4,1,2,1,8,1880207.90749796,4995178.46988223
27,0,3,2,4,9,2065116.73769146,3913451.49667462
19,2,1,1,0,4,1127451.40248589,4574611.97888639
31,6,1,0,3,10,1175762.38377752,6794914.65095907
23,4,0,2,5,11,2224547.98499921,5058285.688379
27,6,1,1,7,15,2273233.66108859,7209999.58762661
14,3,3,0,4,10,1738440.40613293,3780160.09310577
12,6,0,2,1,9,2644941.85407498,5491989.33843265
22,5,0,1,7,13,2138724.18120693,7688303.86205146
39,2,1,1,4,8,1938928.58521612,6392496.17522928
17,1,0,2,2,5,1548994.26960809,4493146.22376677
36,4,0,0,0,4,1132134.18391633,4673693.44396281
30,5,2,2,0,9,1823823.52163843,6537842.20594239
30,1,0,0,7,8,2070914.51260189,3700513.24079078
27,0,3,2,1,6,1835831.43661408,7575088.18434782
39,2,0,1,6,9,1949246.26923235,5839431.31127241
11,1,3,0,0,4,984002.903734914,4103015.9852169
28,3,2,2,1,8,1953160.35224994,6436521.56368464
21,6,2,0,4,12,2274436.85650138,5657608.02116883
12,5,2,0,1,8,1829349.59992987,4725307.29697988
25,4,0,1,7,12,2429303.7754441,7155610.10438373
28,0,2,0,6,8,2017255.86301706,5970612.76285694
26,4,1,0,2,7,1228645.00588904,5306672.23565811
16,0,2,0,1,3,1307568.84545856,5355475.43484895
10,0,0,2,1,3,1208668.4184639999,5422367.08996486
13,2,3,1,7,13,2427477.23014855,7605891.71246885
15,3,1,2,7,13,2451541.07233127,9661737.52163886
34,6,3,2,1,12,1660679.91296733,5304987.70981324
26,1,0,1,7,9,1573432.9306593,4751935.39685908
20,6,1,2,4,13,2647404.0842983997,8227026.0380521
14,2,3,2,6,13,2369776.79799008,6734521.82396657
40,4,0,1,6,11,1903983.89583956,3572787.74370744
40,5,3,1,4,13,1883909.32706336,6918055.14042707
28,6,2,0,5,13,2017873.28729112,7280517.38135428
19,4,2,1,7,14,1390271.99576914,10588519.9675603
22,0,3,1,0,4,786779.279904363,6642184.17352072
20,1,3,2,1,7,1569968.14445834,2998651.40370246
21,3,1,1,5,10,1320399.15022142,6540783.17794338
29,3,1,2,6,12,2091481.02470146,5212562.88796788
37,6,1,1,5,13,2305754.1397567997,6422815.55102785
16,0,0,1,4,5,1394229.28030928,5702843.74350693
35,6,1,1,0,8,1760650.75918685,4116486.03984499
31,6,0,2,7,15,2029703.20118411,9674298.10928907
14,0,0,2,1,3,1320061.69733783,5568274.8632885
27,5,1,2,3,11,2114808.89227687,4869103.30119705
15,0,2,1,1,4,1487986.75596277,7203398.19294521
10,4,2,0,2,8,1663636.61477307,7129795.86752826
14,5,2,2,3,12,2578735.94068981,6988260.11174604
28,5,1,0,2,8,2065375.61756842,4948794.85400139
12,5,1,0,1,7,2041378.45157081,7271853.77055181
18,0,2,2,0,4,1211481.74124841,2033165.15796994
28,4,3,1,4,12,2711493.87229379,5990726.41504956
17,5,1,0,0,6,1483105.71426584,6078731.24384388
29,1,0,1,0,2,1446198.36420008,2792511.98603308
15,1,2,0,2,5,1197563.8141283998,5098501.99027646
13,3,0,2,2,7,2031330.60917578,6307248.2100720005
19,0,1,2,2,5,1532896.30494505,5244988.45735144
11,4,1,1,2,8,1853815.33965952,7215442.92357209
15,3,0,2,3,8,1823674.28810323,4483698.949415
35,5,2,1,1,9,2311109.47607122,6336462.17242843
21,0,3,2,6,11,1691641.50357663,5896783.86723179
37,3,0,2,7,12,2533295.22382404,7551943.51137248
28,2,3,0,1,6,2077805.32878605,3947766.54716922
20,2,1,2,0,5,1794939.9200813,4687403.66215754
23,6,3,2,4,15,2907251.62828893,3441117.16702432
29,5,2,1,5,13,2370862.52319086,7854661.27495988
29,1,1,2,1,5,1073138.43683228,5908745.79479699
17,4,2,0,0,6,2011890.28523761,4342428.08207087
24,4,3,0,1,8,2325574.96986724,6215921.21438055
38,6,2,1,2,11,2325397.04882313,4601049.59695015
15,6,3,1,2,12,2561060.16311656,6351943.45790981
28,2,2,1,4,9,1897915.16287268,3476719.94669372
36,1,3,1,7,12,2476951.95013848,12244055.5485306
38,6,0,2,6,14,2457311.94010187,5001213.44882798
17,3,2,1,2,8,1861476.98963202,2387340.72098049
16,2,1,2,1,6,1364970.22699005,5038025.53596602
10,1,2,2,1,6,1913091.39660947,3409176.82780774
13,2,2,2,2,8,1807316.68993259,3414799.00669328
37,1,0,0,3,4,1377583.14579819,3808202.49328576
18,4,0,2,0,6,1768226.96818894,7171451.66724515
12,3,1,0,4,8,2315145.49777689,8894250.85144714
28,5,2,2,0,9,1663141.91859898,7903952.48545358
14,3,1,1,3,8,2029162.08539922,5644248.48683283
33,1,3,1,0,5,1281012.66065932,4353954.79998685
25,3,3,2,4,12,2093500.00275438,8489909.13446123
30,3,3,0,7,13,2202285.74823571,4775706.73789194
32,5,1,1,7,14,2023477.95794287,5347853.73271762
11,0,2,1,6,9,2165323.35256919,6678153.20453285
15,1,1,1,4,7,1726087.96929351,5301588.82742741
16,2,1,1,7,11,1959295.75574896,5125204.65178851
31,4,1,0,6,11,2155268.77852718,4272466.80493166
29,5,2,1,7,15,2313433.59147889,6284383.28896425
22,6,2,2,1,11,2265953.9231674997,9088912.32426178
13,1,1,2,4,8,1495358.8255083999,5275029.5101892995
13,4,3,0,3,10,1999291.36942019,9393922.68896604
24,5,1,0,4,10,2217837.92909646,5245633.75307315
20,2,0,0,3,5,1853412.89581543,5321378.169166599
34,6,2,0,3,11,2076628.36427697,8153941.57247061
17,6,2,0,2,10,1934454.52158029,3330525.52150248
23,5,3,1,4,13,2934660.76835333,6673071.47286304
25,0,1,2,1,4,1446443.34907563,5488555.45129311
35,3,3,0,4,10,1889044.41815593,4331746.15806036
29,0,1,2,4,7,1647924.16744329,7449313.14072244
22,0,1,0,4,5,1343360.54523317,3796005.52667228
12,3,0,1,4,8,2057574.70887142,4035501.85522325
29,3,3,2,4,12,2312626.04382709,6283855.39259051
34,2,3,0,6,11,1910888.89764105,6810243.22833371
19,3,1,0,2,6,1704432.41725946,2730604.22944287
15,6,0,2,6,14,2231135.83236518,5585877.8835327
10,5,3,0,1,9,1881287.20938157,3908440.601987
30,2,2,2,0,6,1694847.01663747,5819115.83706171
34,4,2,1,2,9,1996129.45932531,5989199.97492356
10,3,2,0,6,11,1576609.08093094,9021134.29076249
10,0,1,2,1,4,1491595.94532885,2582627.1349247997
16,6,3,0,6,15,2838438.98394739,6587681.65799765
32,4,2,2,7,15,2763726.65111005,2480716.66151782
36,5,3,1,2,11,1964794.56338605,6350168.59080856
37,3,3,2,4,12,2444803.80554602,7516472.22729454
12,6,0,1,4,11,1778203.24208839,9570065.40824664
30,1,3,2,4,10,1900387.05340224,6792780.68719461
15,0,0,0,3,3,1629748.50809408,3628348.35836469
12,3,2,1,1,7,1863184.94534318,5452101.09376551
12,2,2,1,0,5,1089934.95903909,5613601.32398979
27,4,0,2,7,13,1854091.42377711,7327015.60513127
23,1,1,2,5,9,2312476.01569347,5870284.91593703
26,0,1,1,5,7,1617321.14765126,3965219.85076472
10,2,0,1,2,5,1953452.13914423,5325082.57388128
15,3,2,1,2,8,1868355.47941053,5146114.27394644
37,4,2,0,2,8,1431813.97513824,6536404.08895855
12,6,0,0,3,9,1631970.22064612,8198474.20056259
40,4,3,0,1,8,2186834.8304994,7757102.70953301
32,3,1,2,4,10,2413960.91491628,4182620.8652298995
26,2,1,2,0,5,1732089.17130501,5721888.41230735
22,4,1,0,1,6,1341584.39911884,1856479.81539229
37,2,3,0,4,9,2328552.57264125,3385123.11610557
13,5,2,0,1,8,1337277.26526432,3973430.33938675
23,0,0,1,3,4,1075728.80192046,2816068.39969781
17,0,2,0,6,8,1777070.5070771,7664509.86524178
20,6,0,0,4,10,1969041.75638406,6652770.39472692
33,2,1,0,3,6,1338352.95191876,7405965.44972552
35,2,3,0,5,10,1841410.30573533,5943333.12202164
24,0,2,0,0,2,1195447.32739237,3627867.57583578
23,3,1,1,0,5,1134840.93856237,3964677.50046184
14,4,3,2,1,10,1413723.03997338,5241219.77806363
16,2,0,1,5,8,1352648.09368885,6698338.1319438
20,6,0,0,3,9,1912476.82951293,7991066.31072141
10,3,2,2,0,7,1433106.11256068,4739281.60305788
20,0,0,0,5,5,1687579.60610893,5442375.57861565
14,4,3,2,7,16,2648079.61320484,9835413.64703595
35,1,3,0,3,7,1954140.59514069,2640451.69513116
32,2,3,1,7,13,2946384.68599037,5853540.99968285
13,2,3,0,0,5,1357202.35156542,3290040.06047986
17,2,3,1,5,11,1987007.7394312,6407630.301984
17,5,3,1,4,13,1931790.82765288,5376051.65425421
10,4,2,0,1,7,1326233.49051195,4438742.70720057
30,0,3,0,6,9,1714131.42286656,5224930.15992233
36,6,2,1,6,15,1533066.47591477,4648105.52003818
19,4,0,0,6,10,2293543.3356979,4011548.33978599
15,1,2,0,1,4,1274553.4057598,5702851.53250292
15,0,3,0,4,7,1484041.98611493,5782947.95858626
20,0,2,0,3,5,1623828.85195991,4478842.78408346
15,5,0,0,5,10,1951506.30549895,7491691.96593156
34,4,1,1,0,6,1866860.16585423,4517770.57284764
31,5,2,0,2,9,2212542.17564181,4403779.29630108
16,5,2,1,5,13,2992801.99801788,5119975.24412956
13,5,1,0,1,7,1680943.36979875,4100136.56690982
38,5,3,2,3,13,2577601.70844402,9173652.99958925
13,3,1,2,6,12,2242188.22474672,6381901.79198577
11,0,2,2,6,10,2236710.25851598,5841622.55245652
30,1,3,2,4,10,1793201.46506998,6581899.64968737
11,2,0,1,6,9,1881598.37863764,4900796.65619713
18,1,0,1,0,2,1366493.58073292,225354.701439999
16,6,3,0,1,10,2517919.30468987,7868551.404442701
19,4,1,0,2,7,1414625.32043948,3529311.98430787
28,1,1,1,7,10,2078567.88858707,6607972.21785975
35,4,3,1,4,12,2428754.50303645,4233339.82741276
38,3,0,1,6,10,1969659.44099737,11486098.2474263
40,6,1,1,3,11,2065344.0527878997,5479670.19640375
10,6,1,2,4,13,2505612.72551791,5983902.77375258
26,6,0,2,3,11,2105503.72462299,9235424.71934527
13,3,2,2,6,13,2809195.26118184,5979934.1856197
36,2,2,2,5,11,2234055.37349518,8624867.00053231
18,1,1,1,2,5,1521624.84168992,2698960.45890498
20,6,0,0,5,11,1985568.56570825,2671857.97396558
33,1,0,0,1,2,1200714.69899424,4367546.0706674
40,1,1,2,1,5,1367966.00080161,3594667.35209967
14,4,3,2,1,10,2356659.56043632,7123468.88867979
29,4,0,1,5,10,2167613.07691235,4752572.81368705
18,6,0,0,0,6,2014220.90454092,7936464.9090227
24,1,3,0,2,6,2009258.68266022,7534436.84551485
39,0,0,1,1,2,1051221.36675362,3674025.42134656
15,1,2,2,2,7,1763112.14917713,2688666.73924334
31,6,3,1,4,14,2264241.00405208,7356372.61382362
22,6,3,2,4,15,2020562.32888163,8361837.77691505
15,0,0,2,3,5,1772607.21540315,5868937.34094626
17,0,0,2,2,4,1650524.72008093,6691694.94900528
12,1,2,2,2,7,1451801.52121263,3333247.4221063
13,6,0,2,7,15,1906138.3721323002,6845891.94203352
30,0,1,0,6,7,1696536.31964812,7734604.43364016
14,0,0,0,1,1,1032903.14824574,4247789.7093183
37,6,1,2,2,11,2499337.31287087,8788680.72784456
19,5,0,1,7,13,2973868.39696084,7416181.42649979
13,6,2,1,2,11,2392159.64957353,3717105.88794338
29,4,2,2,5,13,1297185.99868815,8789687.94861161
35,1,1,1,3,6,1631342.66666547,5628460.77108853
38,1,2,0,7,10,2192215.42184616,3144726.34967115
38,2,3,0,6,11,1947528.79489552,4989348.02601085
32,3,0,2,4,9,1579903.48279459,5395240.90171964
10,5,2,0,3,10,2264908.63093025,5486242.40776378
20,5,2,1,5,13,3395752.5077871,3300719.35754225
30,0,2,2,7,11,2165778.00104881,4382002.85115726
28,0,1,2,6,9,2026429.25901842,4964794.80770375
35,2,0,1,6,9,1502720.38726992,4391216.71517711
29,6,2,1,5,14,2484125.21969472,7597508.80465269
28,1,3,1,5,10,1660944.42725988,5952856.91961422
28,6,3,0,2,11,2364918.90679978,5509144.175359599
17,2,2,2,7,13,2177329.18829633,10689842.0806651
17,3,3,1,3,10,1870625.15633645,6583495.31063829
13,4,3,2,0,9,1896379.14541123,6303860.38258734
11,1,1,2,2,6,1496067.97141593,6607374.65061753
17,6,0,2,7,15,2082487.87952709,9344785.55246212
14,2,2,1,1,6,1624315.41969698,5930718.59749619
20,4,0,0,5,9,2036164.59976109,2910849.3208707003
35,3,3,2,5,13,1950076.94250934,9160703.17954085
21,2,2,0,4,8,1624631.41246116,7103019.33055047
15,4,1,2,4,11,2622407.09686394,5525303.11710471
25,2,1,2,1,6,1906313.80341402,3851032.76637088
10,4,2,1,5,12,2513689.10764379,7143226.25871491
32,1,2,2,4,9,2408724.56665166,7023955.57606448
20,2,0,2,7,11,2592257.49721924,9657320.1096158
14,1,1,2,0,4,1256488.60794555,4199974.72969563
31,2,3,0,7,12,2121244.29615691,3511498.50717419
33,4,3,0,4,11,2085922.74920211,7766667.35842893
36,0,0,2,0,2,1040859.06165601,3650747.94560774
31,2,2,0,4,8,1788016.98029648,6799293.88083695
21,2,2,0,4,8,1602981.00208389,1602981.00208389
39,4,0,2,5,11,2846202.46606103,6280437.503707901
17,4,1,1,6,12,1989835.77723788,5897781.65098413
36,5,2,0,0,7,1682910.30529097,4222727.17990709
31,6,0,1,3,10,1642380.60745484,6710408.42146385
15,2,1,2,1,6,1486235.77884736,4733754.20478379
37,1,3,0,7,11,1877998.51801031,7912968.32047421
10,3,2,1,7,13,2331990.04483154,6251976.69194745
17,1,2,2,0,5,1108126.5597326,6144393.65636777
34,2,2,1,4,9,1819435.86081474,2620543.26088434
32,6,2,0,5,13,1339178.85222512,7482271.87286052
19,5,2,2,2,11,2045856.82938566,6551040.61739384
36,0,2,2,3,7,1398624.50281386,4517544.01572707
24,3,1,2,3,9,1908100.87819618,4406684.52842075
33,2,3,0,0,5,1338256.63358183,2580311.05644907
25,6,1,0,6,13,2269329.64017951,10794480.4360027
34,5,0,1,4,10,2149524.88101271,3261079.69755652
35,2,0,2,1,5,1216929.56929249,2484744.43840241
10,5,1,0,1,7,2052040.13446833,5628586.31234497
18,5,3,1,7,16,2934322.85940748,9219025.9231639
12,2,1,0,4,7,1950048.9898396,6163950.83082739
29,1,1,2,5,9,1765154.51044853,5977289.51874282
30,5,1,1,4,11,1968562.28616707,2402726.39111698
40,4,1,0,3,8,1995212.91943883,6924862.27872458
11,0,1,0,0,1,694745.234107828,2946203.78381427
23,6,3,0,2,11,1765609.34910889,9097345.1416273
25,1,0,0,1,2,1249202.59350207,2598034.00524336
13,5,0,0,3,8,1641073.56062988,8163054.21713463
11,3,1,1,2,7,1922687.71778847,5884001.20056766
24,5,3,1,4,13,2027658.5049198002,5516067.39590434
20,1,0,1,6,8,1586174.76296766,4499266.46067998
31,3,1,0,1,5,1696263.6712578002,5198191.71923927
40,1,1,0,0,2,1226087.92415807,5684417.52792519
11,0,2,1,1,4,1372569.16826609,3441224.35132131
34,2,3,0,7,12,2250720.12632929,7506195.15351036
24,6,3,2,4,15,3024766.28100438,7147307.94854621
13,4,1,0,2,7,1574946.37725031,2351784.43645557
25,5,3,0,1,9,1692613.19071062,4831859.38078746
30,6,3,0,6,15,2680592.76903447,7155505.51402571
34,2,0,0,2,4,1389821.41707048,5242241.68629076
37,5,2,1,4,12,2150380.59879296,8115309.118617
36,3,1,2,6,12,2125146.15303982,5791435.20754036
33,0,0,1,1,2,1232008.69147339,1504141.59608109
14,2,0,1,2,5,1621802.7310052,2707889.41803667
24,1,0,1,0,2,1155900.76767774,2746075.45674588
31,6,2,1,5,14,2704656.46942385,5765982.02173269
26,4,3,0,7,14,2501942.13488105,5998971.0287431
40,1,0,0,5,6,1656717.32618127,3787374.82293659
16,5,0,0,2,7,1844660.92840917,3345022.97188792
25,0,1,2,5,8,1953074.82620411,4442650.93754488
31,3,2,0,6,11,2390455.5268543,9077647.26849006
21,0,0,2,4,6,1953633.2495331,3793770.6195457
32,4,2,0,4,10,2313495.83912188,5799231.30363452
10,6,0,1,0,7,1996939.92800691,5335917.34807956
33,4,1,0,2,7,2028725.90112281,9465679.59607755
27,2,3,0,7,12,2489810.11682017,4181149.66092723
37,4,2,0,6,12,2649839.04990278,7526398.52283711
28,1,2,1,0,4,1427745.30890415,3784071.54938117
24,1,1,2,0,4,1390764.1863969,7899837.71833673
31,4,3,2,7,16,3374211.46473009,5327793.08659805
24,1,2,1,4,8,1674372.04975635,3539767.86672205
24,3,2,0,1,6,1956398.71713897,1700075.00087118
23,4,0,1,5,10,1652646.08908661,5123742.94421349
35,4,1,1,6,12,2133568.47029008,7139310.16835196
24,3,1,2,5,11,2454366.24711736,8785574.11156937
14,3,3,1,4,11,2188646.99169722,5698628.2140608
34,1,0,0,7,8,1670692.16549383,5046471.05476706
26,4,2,1,4,11,1452265.81794467,7477095.09873746
12,1,1,2,6,10,1657772.99654015,6250591.49694775
10,5,3,2,6,16,2244974.56030099,7327388.80745021
17,4,2,1,3,10,1665738.45937369,4031833.27680787
12,3,3,0,3,9,2213831.74566471,5380903.17209189
20,2,0,0,7,9,1623276.26198508,7881990.48618621
33,6,3,1,0,10,1983015.48475694,1611158.59951238
14,4,3,0,5,12,2473845.52099037,7022044.54578342
19,3,2,0,1,6,1565533.84001903,5376923.37080215
21,1,1,2,4,8,1715426.7843913,4438982.99817441
21,3,2,2,5,12,2585463.22509919,10006579.612010302
29,6,3,0,1,10,1710767.94857979,6578547.62694575
24,6,1,1,7,15,3115360.80503076,6424698.48706506
27,6,0,1,3,10,1774207.38896952,5293527.76201583
36,6,3,1,0,10,1775593.58468009,9336917.88430872
27,6,0,1,0,7,1840741.96870919,9028319.7141262
28,1,1,1,7,10,2192316.75121796,8431594.30992075
16,6,0,0,6,12,2543974.69576675,6637023.39549398
36,3,3,1,4,11,1933521.18949295,6484756.5470249
33,5,3,0,5,13,3096913.35759691,5271650.12942385
37,3,2,2,1,8,1830121.09614309,6190506.22959479
32,5,3,1,3,12,2331261.95725764,8168189.06560114
15,4,2,0,2,8,2372784.22809938,5124354.48785978
33,4,2,0,4,10,1862165.73688685,6040193.07244712
13,5,2,1,4,12,2327584.50247206,9021642.85868318
27,4,2,0,4,10,2139060.33009516,7569064.90138664
34,3,0,0,6,9,1795428.7578985,5998036.13672221
35,6,1,0,7,14,3252215.70676967,4056463.16659309
29,2,2,0,7,11,2493757.58074503,9101950.97719901
12,2,2,0,0,4,1403259.92600439,2607821.67240731
11,0,0,1,1,2,823341.8357745791,674335.231063881
35,5,0,1,7,13,2258744.05081041,4665267.10940357
29,5,1,2,3,11,1789397.83870835,8284772.80255812
10,1,3,0,3,7,1255134.13629863,2600103.48578714
12,5,2,1,0,8,1748717.16537181,3424827.56929502
13,4,2,0,2,8,1859006.48724765,6110757.27559011
32,1,2,1,0,4,1377855.92411244,5037853.08606455
39,5,3,1,6,15,2106215.53554042,9118576.32950099
30,0,3,2,4,9,1811868.51678409,6912624.97116398
19,1,1,2,4,8,2110916.9617745,2822299.09841757
31,6,1,2,4,13,2062655.20157161,5666127.91035719
17,4,1,2,6,13,2716096.61534067,7663659.01171635
33,1,0,2,3,6,1537378.19323761,4018263.17491916
34,3,2,0,4,9,2031372.34374606,6520966.94199992
37,5,1,2,2,10,1855647.34301764,8179337.92435897
20,6,2,0,0,8,2272960.74765547,5119857.84494301
14,1,3,2,7,13,2234474.88374905,4341926.96940165
13,6,3,1,7,17,2676539.44198592,13984296.531658
27,0,1,1,6,8,1042788.17700822,4576251.42442924
25,1,2,1,6,10,2417472.82628084,3311324.02178558
13,3,3,0,0,6,2024663.72316781,1409991.77110533
20,4,3,0,3,10,2278882.32016578,9345343.40589215
29,2,1,2,3,8,1672004.64248053,5489144.76292094
17,4,0,2,7,13,2192402.5020049,343578.665272361
32,4,0,1,7,12,2027283.23546497,5294772.53120262
23,4,1,2,5,12,2618818.4473027,7012456.8631138
24,5,3,0,1,9,1654271.42803204,5859044.12030817
20,6,2,0,5,13,2077122.08122166,4884756.48132402
10,0,0,1,7,8,1556044.14682457,6226259.27830609
25,6,0,0,4,10,2223646.06547314,6413725.05108251
36,1,0,2,2,5,1168880.98781367,6783510.98425352
35,5,3,2,4,14,2917396.30957958,10121303.467972599
26,4,1,0,0,5,1565374.44815642,1921964.21505092
21,0,3,0,1,4,1212714.10927671,5496048.6986635
36,0,1,1,6,8,1829496.55126335,7434716.31066776
11,2,3,2,7,14,1731895.66820833,6136651.78255174
14,0,0,2,2,4,1304824.31213238,5799708.01052498
10,4,2,1,3,10,2294405.70778794,6637561.65007327
11,0,2,2,3,7,1125779.05776342,5220370.51758009
36,4,0,1,6,11,1238981.57276267,6118283.974046401
25,6,3,1,6,16,2340531.37955563,9917674.76745075
27,6,2,0,4,12,2412319.95969217,7753752.47519819
11,2,0,0,3,5,1344036.25810957,4171145.71557768
24,3,1,2,4,10,2238383.59538495,4771498.78503339
32,0,2,0,3,5,1849642.1567571,3917364.98313222
17,5,0,2,7,14,2886767.51794825,8189725.85153991
30,6,2,2,2,12,2235733.72295902,4817019.49724343
36,5,0,0,0,5,1796673.09198684,6786158.39261457
29,3,1,0,3,7,2117717.20807708,7332381.63435996
21,1,0,1,1,3,880495.908620645,5293117.7832623
28,5,0,0,4,9,2239054.43312685,6515785.29111367
19,2,2,2,3,9,2392003.21767677,6942721.00120542
28,4,2,2,5,13,1900666.14148622,8474349.8912908
16,3,3,1,2,9,2084258.48811383,5184914.77258017
22,0,1,2,5,8,2409758.52534216,3255560.51233987
35,3,2,1,1,7,1987771.14462964,3821118.1982992003
13,3,3,0,6,12,2514262.89442861,6190632.61473252
27,0,0,2,6,8,1686013.43270968,7701787.12267136
36,6,1,2,1,10,1805070.91635029,6934520.20641487
35,2,0,2,2,6,1503865.98313099,2604647.55087898
29,0,3,1,2,6,1407518.47217977,5824736.09881505
35,6,2,2,0,10,1795024.6593429002,7845975.26715563
16,0,1,0,5,6,1736667.18008228,3298978.99228526
39,4,3,0,6,13,2005850.68579392,7760824.07206029
37,1,1,1,2,5,1158540.75990323,2623111.33775565
17,5,2,0,4,11,2060140.76149335,6310281.02333081
38,1,3,2,0,6,1455447.40171697,3733193.51084352
31,1,1,1,5,8,1997892.73583548,8403640.73913963
11,3,0,2,1,6,1564079.57586516,1084809.60761604
18,0,0,1,7,8,1697819.85585522,5392399.34618562
32,2,2,1,4,9,1981464.14308335,5137771.97818219
38,2,0,0,5,7,1478600.55857281,5126469.0077546
12,1,0,1,7,9,2124157.93390003,5907636.48876107
40,3,3,2,2,10,1789368.04066425,6460567.92910948
23,5,1,1,3,10,2194762.07688438,8081941.33277114
40,6,0,2,0,8,1884118.68768318,8151870.11661635
27,0,2,2,0,4,1300674.79471659,3255697.58410383
22,1,2,1,6,10,1823948.9209848,5849129.73566121
40,4,3,0,0,7,1476510.38920993,4440903.59098476
26,3,1,0,0,4,1093125.25882056,4635550.00286614
31,4,3,2,5,14,2197229.27039909,7676294.8802453
20,4,0,0,1,5,1400871.40088253,4003396.68767206
40,4,3,0,7,14,3001852.00337783,9035437.40228281
14,6,2,1,3,12,2488068.2017334,1962044.30669839
33,6,3,2,1,12,2209349.28403331,7353421.62014768
33,1,3,1,5,10,2221011.75901999,5036968.16145972
14,5,0,2,6,13,2860520.81936946,8961708.52928635
39,1,0,0,2,3,1251708.00607503,4132364.24497843
10,0,0,2,7,9,1854567.77189985,4990571.6240644995
18,0,2,2,1,5,1185203.90760047,5155430.96475885
36,5,3,0,0,8,1410328.01642535,4082449.19291825
35,1,1,1,1,4,1390056.13060848,5064856.91981183
28,4,0,1,2,7,1422741.98006292,5551332.28901016
40,0,1,2,0,3,1105410.17907324,1136386.75353647
10,2,1,0,0,3,1581500.16540003,3361683.9721059
38,2,1,0,5,8,1299929.00583947,4781567.00564036
29,2,3,2,1,8,1680907.13786853,6879124.05345982
19,6,2,1,0,9,1713254.2234852,6346537.43169436
19,4,0,2,2,8,1955752.06888578,4164636.96842484
10,4,2,0,0,6,1697664.11786169,5621782.58603464
31,6,3,0,0,9,2180932.36029366,5327989.90237874
20,6,0,2,3,11,2518215.0902198,10075287.4602672
33,6,1,0,0,7,1587623.17447928,1575299.1970263
14,0,0,2,0,2,1187720.73960112,5681746.38573417
13,6,0,1,3,10,2019041.01237669,5752359.40794786
12,0,0,1,4,5,1376785.39368655,2101464.89951078
12,5,2,1,7,15,2350139.67507014,7349443.72269618
16,2,1,1,3,7,2433222.80436804,4916961.27893472
20,5,1,1,7,14,1632141.71192778,5815193.34311627
15,2,1,1,4,8,2226020.15325587,4607151.00114188
31,4,0,1,1,6,1688519.62201901,3784487.60335199
11,1,3,0,1,5,1730673.43912282,5219428.2821697
25,4,2,0,1,7,2089746.2018614,5737649.47250686
22,1,0,1,3,5,1514019.60395082,2717236.7996326
39,0,3,1,4,8,2001858.85758233,4211412.22836845
33,0,0,1,2,3,1292227.56548968,3418301.63010313
26,0,0,0,7,7,1965206.02917889,8850778.11777499
40,2,2,1,3,8,2315628.64120385,7113887.0651223995
19,5,0,2,6,13,2947279.78781195,6382366.380517401
11,3,0,1,4,8,1459455.11038452,5961265.77704861
17,5,3,2,0,10,2066421.49630138,7191037.89355901
23,0,0,2,4,6,1551381.78730788,4160779.79918759
15,1,3,1,6,11,1827034.87721589,9307777.07321589
20,0,0,0,5,5,1888849.73746668,2817495.30385854
18,6,2,2,7,17,3365139.02646823,12615407.8746098
38,4,3,2,3,12,2139616.52435484,7699242.37914414
36,1,2,2,3,8,2131839.96132451,4959435.97285676
20,6,3,2,4,15,1914446.58924801,2108158.03149329
17,2,1,0,0,3,1495378.30850947,4912233.01531431
14,6,1,2,4,13,2267126.77860908,8307768.51575003
28,4,3,1,7,15,2686045.10418776,2427080.34786404
27,0,3,0,0,3,1610056.40347843,3972317.15109663
26,0,0,0,6,6,1678814.29060433,5369940.97445269
17,5,3,0,2,10,1790304.97469937,7901315.90159889
30,3,1,1,4,9,1952506.67473177,3835039.71802462
24,0,0,2,1,3,1103427.36162578,2944278.63283591
18,2,2,0,0,4,1803389.66324591,3517550.41235765
36,6,1,0,0,7,2153792.01798229,5473315.90554591
27,0,0,2,3,5,1277288.23259121,4650124.3993931
30,1,3,0,4,8,1826157.97733405,5802229.12690026
18,2,3,2,5,12,2238928.46323152,7807570.64262874
36,5,2,0,0,7,1729992.60836039,3698953.51679993
12,1,0,0,3,4,1330199.92327565,5844386.97896216
33,1,0,0,0,1,1131042.17521897,6022275.57110385
37,6,3,0,2,11,2517412.14696724,7909985.51933744
16,2,1,2,3,8,1647172.46288627,5774030.3608515
32,6,3,1,1,11,2259063.4938986,9078630.95525718
11,2,0,1,5,8,1919728.49412008,6103103.10984079
17,4,1,1,0,6,1721986.36670773,5199824.52341349
14,6,1,2,4,13,2180521.50746629,8372909.127119999
17,4,2,0,4,10,2021793.41087059,5408249.04549017
29,3,0,1,4,8,1572499.25868252,6282515.72758741
35,1,0,0,1,2,1023597.73562319,7031305.58843235
18,6,2,1,1,10,2134825.73947143,5013463.28212649
27,5,0,0,6,11,2018100.77858015,5576832.71346949
25,0,0,2,1,3,1476369.98423967,4798990.31608249
23,3,2,0,4,9,2066004.83389812,8126459.58960745
13,1,1,0,5,7,1733904.50514561,6278810.07510382
24,1,1,0,7,9,2357034.15639993,4696685.35418378
16,1,1,0,7,9,2083344.45956879,3626519.41691286
23,0,0,0,7,7,2043412.14576927,8619883.03604473
32,4,3,2,4,13,3087834.38072105,8238992.43640042
22,0,1,1,2,4,1563024.83266975,7581188.90942025
40,4,0,1,1,6,1504057.90028905,5290751.57682916
34,5,2,0,2,9,1800000.87098416,5542798.99041668
29,5,1,2,4,12,2188866.14426049,6120603.37991126
21,3,0,1,4,8,1532927.59923477,5784106.61862589
17,0,1,2,3,6,1783905.27853625,3154970.90041539
12,4,2,2,6,14,1856092.10403527,7901447.73396062
16,5,1,0,5,11,1816199.25614905,6197905.78337638
16,3,1,2,1,7,1688104.91332312,5323019.70024269
28,0,1,0,1,2,1089673.65757421,4335668.79500592
15,0,3,2,3,8,2308602.96942705,7331981.65178326
24,3,0,1,7,11,1656531.34698132,5179499.14850817
40,5,0,1,7,13,2330224.17889606,8473609.38885245
31,4,2,0,7,13,2722546.37041198,6382368.41302601
12,2,3,2,6,13,1613643.88182966,6106177.06597006
33,5,1,2,7,15,1543352.91800034,5712667.67121435
36,2,3,0,1,6,2099739.71892734,5176316.76415757
12,5,1,2,7,15,2256272.03212265,3321808.40134693
32,2,3,2,7,14,2481506.47862101,6796069.06878675
11,3,1,0,6,10,1996433.11770448,4641108.49576097
27,2,1,1,1,5,1290621.05527031,5677613.12174721
25,3,0,2,6,11,2410723.62003006,6991483.9602677
39,0,1,2,1,4,1565747.07523576,2027608.25503368
19,1,0,0,3,4,1442651.33092974,3793959.14651553
32,3,0,0,6,9,2418112.4482954,4923781.55380925
24,6,1,1,3,11,1990433.78999361,4313511.53998667
36,1,0,1,1,3,1345528.85066697,3188471.43015722
14,2,1,1,1,5,1836666.47079038,3172786.04515109
21,0,1,0,6,7,2010966.03562985,4236023.48529793
35,5,1,2,0,8,2016952.23059872,4223843.05471004
12,2,3,1,7,13,1943357.21466555,8244891.24407613
34,3,3,2,2,10,1623796.6774447,3190695.2960658
39,1,2,2,7,12,1988677.11029474,7209492.77028048
30,2,2,0,2,6,1713512.65280593,8191492.48843439
36,0,0,0,1,1,1210008.2790265,2233715.5448457003
38,4,2,2,2,10,1828097.08950921,5055388.50523135
21,2,0,0,4,6,1546929.26289317,7341038.79276213
10,6,0,1,3,10,2553474.31487043,4741583.35410957
32,1,3,2,4,10,1948357.50219858,5573159.22357413
20,6,0,1,5,12,2152003.18883568,7056476.23135393
12,1,0,0,4,5,1655585.96594066,6629042.65604856
24,5,1,1,7,14,1479715.40254607,5227910.95990013
17,6,3,0,7,16,2463855.62065355,6009513.68924243
40,3,0,2,0,5,1589247.50739872,4371219.97275275
15,6,0,2,3,11,2440465.1022571,6067648.92546722
10,3,2,1,3,9,1826851.0601369,7338653.73060292
23,5,2,2,7,16,2796861.98314401,8248752.90884174
12,6,3,0,3,12,2613952.67232221,9937804.80682918
12,1,1,0,0,2,1099886.02655102,3317816.89094769
20,6,1,0,2,9,2247914.18958179,7448040.6850261
31,2,2,0,6,10,2552274.13729649,3670906.87335907
11,1,1,0,5,7,1677506.71597011,5981992.81008701
39,3,0,0,1,4,1273524.90385954,4693012.69600294
36,4,3,2,3,12,2151523.67732125,4483527.49493081
14,0,3,2,1,6,1384298.5004201,4722449.18941573
39,1,0,2,4,7,1961780.31658096,4208735.38063744
10,1,0,1,3,5,1481793.41440084,3410951.01010865
36,4,0,0,2,6,1500022.90895234,3481230.55268339
20,2,0,2,4,8,1342074.48319341,6713160.79767364
18,6,2,0,1,9,1648549.36423827,5843438.13596154
18,6,1,0,2,9,1444411.13012842,6000762.889176
31,5,3,2,1,11,2450309.96462313,6891563.10350986
18,5,3,1,6,15,2437812.92318134,9183297.74854783
15,3,2,2,6,13,1913360.29512764,7692997.01666959
35,2,1,0,3,6,1683482.18155788,2397526.75862358
33,6,3,1,1,11,2517735.24902502,4896525.11927984
19,2,2,2,3,9,1825081.45325914,3223166.63639423
23,4,2,0,6,12,2017910.04399943,9668693.10778838
11,0,3,0,5,8,1527433.63329328,8759327.02354649
38,1,0,1,5,7,1479565.89205435,4871654.10598732
27,1,2,2,1,6,1844550.36952273,5551153.35904273
23,3,2,0,6,11,2327675.47244615,7684994.98594115
39,6,3,0,4,13,2207675.83715149,4688396.31857847
26,3,1,1,7,12,2418712.11730693,6337029.51585521
25,3,0,1,6,10,2118657.31232182,6546161.74637064
36,4,3,2,5,14,1986105.75559616,7013783.47981378
26,3,1,1,7,12,1606422.65054395,6209553.18734941
37,5,3,2,6,16,2867318.24826532,10085760.9065373
29,3,1,0,7,11,2503311.28772427,5602247.25287237
24,2,0,0,1,3,868630.300049003,5657681.56335708
17,0,3,2,6,11,2712054.71306496,4363739.83921778
18,1,3,2,2,8,1720114.17385953,5553877.481505999
33,0,2,2,7,11,1589945.30851303,6129021.78830648
39,5,2,1,6,14,3342109.01936845,6673148.38904499
22,1,1,1,0,3,1208245.59105423,1225209.04098924
19,1,1,2,1,5,1508881.04598673,7109507.08678238
25,5,2,2,6,15,2337818.0126332995,9812698.49184745
20,4,3,2,3,12,2010508.38038272,6683482.35516759
12,0,1,2,5,8,1247989.44016171,4344345.15872956
13,5,1,1,2,9,1872803.84146925,5636602.20092959
20,6,1,0,2,9,1675448.78082947,3316423.87069227
19,2,3,0,2,7,1753484.31839276,3437879.12007497
21,1,2,1,1,5,1536127.84941241,5136983.50177648
32,4,2,1,6,13,1656857.97911043,7055971.95857044
32,0,0,2,3,5,1239403.03844788,7050503.76669535
12,4,1,1,3,9,1883031.12404711,8257536.22592439
39,4,2,2,3,11,2544644.93144197,6062910.76613209
17,5,0,0,1,6,1573198.37726337,4755913.85659416
30,2,1,1,6,10,1789433.42446723,4619760.95554512
39,2,3,1,7,13,2442569.27257694,7261630.24144796
26,4,3,0,2,9,1930639.78514423,988108.8947350329
25,1,0,0,7,8,1722260.13301575,5117722.5090217
32,5,2,1,3,11,1854815.10780811,6298543.03749694
37,5,3,1,7,16,2091337.3996778,7376633.67115596
12,0,3,0,7,10,2224347.27921601,4913332.44497521
20,5,0,2,2,9,1842489.68824021,4044763.99724763
16,1,3,0,1,5,1658534.05903046,3702625.63619005
33,1,3,2,7,13,2871165.1347671,9076492.57174722
13,5,0,0,0,5,1690837.83766025,4439963.1662522005
34,6,0,2,5,13,2291863.56917314,4309132.69010716
36,4,3,0,0,7,1644449.91365836,4797868.39550834
38,5,3,1,3,12,2405045.57032511,7253939.74671953
18,5,2,1,6,14,2537858.55309618,9808867.078668801
20,2,3,0,1,6,1628739.87581726,4119692.34658042
17,4,0,2,3,9,1947033.27151912,8552764.59336942
37,3,1,2,2,8,1813753.40530045,3497414.52978807
34,6,3,0,6,15,2721480.74524714,7042671.58193537
13,2,0,2,7,11,1640665.4976433998,4192397.85995259
32,3,1,1,4,9,1808191.96792918,2237112.20118421
23,0,3,0,4,7,1409167.27110154,2924838.07351489
32,2,2,0,3,7,1623464.36487206,7741352.20974913
22,5,3,1,4,13,2519129.21630036,8137144.15134001
20,0,0,2,5,7,1833653.55526019,6122791.86861302
36,3,0,1,5,9,2385448.17063982,8568021.25488644
24,5,2,2,3,12,2217644.23194316,4994600.01550485
33,4,2,0,0,6,1664186.43923485,4729846.80837037
31,4,0,1,5,10,1900608.85165518,7111584.83333239
35,3,2,2,4,11,1804610.87229112,6174337.18289277
27,4,2,2,7,15,2418195.65921651,7629054.09774044
10,6,3,1,6,16,1906009.59705424,7377963.56781582
35,1,3,1,3,8,2071241.35281999,3964868.09846881
27,4,1,1,0,6,1962913.26937395,4550731.89295603
17,0,0,2,2,4,1432285.23900311,4025747.03744237
39,6,1,0,4,11,2088462.32132241,1642695.98397663
23,1,3,1,2,7,1922336.96944022,4408850.16800278
17,0,3,2,7,12,1762158.49910669,5764823.56452352
18,5,2,2,7,16,2697917.91920911,6513043.463351901
17,6,3,2,6,17,2497623.61218859,5221315.70150965
32,2,2,1,5,10,2008763.95011164,2749551.63923614
17,0,3,1,5,9,1958901.30491151,5290987.84689221
31,4,2,2,1,9,2064011.17230641,7195465.37637171
32,5,3,0,2,10,2099466.84222747,3918230.83268784
24,6,1,0,2,9,2020681.48835933,4932760.26038169
40,5,1,0,1,7,1785899.53373683,5364448.82395114
19,6,2,0,1,9,1718092.63185799,4315175.45791922
31,3,2,0,6,11,1805764.83021722,9082371.46981668
36,3,1,2,4,10,1849597.8941586001,3453574.43809793
23,0,0,1,2,3,1276880.12079425,3900871.17565276
36,2,3,1,6,12,2220592.22935138,6859483.81132324
12,0,3,0,6,9,1943853.61482432,6412927.87173989
27,1,0,2,5,8,1756222.04451466,2248148.0113867996
16,5,1,2,0,8,2440047.5006442,4746322.39633397
35,0,0,0,3,3,1620025.26982509,6868887.35885089
13,4,0,0,4,8,1611866.21890231,5968048.44457147
10,6,1,1,4,12,1969238.3184983002,1969238.3184983002
15,1,2,0,6,9,1538568.95202153,6223639.06690725
36,0,1,1,3,5,1201936.06750309,6646732.60173488
24,0,3,1,7,11,1885529.49924379,8190233.23382991
36,1,2,0,6,9,2079996.716916,5326130.1520372005
21,5,3,1,2,11,2431176.11960342,5091693.18192227
30,5,1,2,3,11,1585242.49592326,2614966.63639226
20,3,0,0,5,8,2142950.25777692,5237828.15881008
34,6,3,1,2,12,2501761.34063269,6507510.20966104
28,4,0,2,7,13,3086458.95659298,7676946.09030697
38,3,0,2,0,5,1642332.82831922,4655361.96372374
21,1,2,2,1,6,1793384.16295765,6855808.27848175
36,4,1,0,0,5,1323230.86703641,2694090.42431106
40,5,1,2,1,9,2290029.71873447,6581822.28073507
38,0,3,2,1,6,1454606.59959482,7723166.66268459
16,3,0,2,7,12,2517023.18864893,8959621.02716334
35,3,1,1,6,11,2827108.53816203,5693762.3069188
26,5,1,2,2,10,2186663.09505523,5742779.83367712
21,3,3,0,4,10,2237061.4083945,8762121.63060708
31,2,0,1,5,8,1539551.10150907,6174407.12460115
30,1,1,1,3,6,1253881.20164764,8674604.30661963
25,5,3,0,4,12,1231977.6968595,8429318.15684407
38,0,3,0,5,8,1554021.17236766,7840185.219672299
20,4,2,0,1,7,1131694.691224,4597908.62547147
30,4,1,2,5,12,2025254.8900369,6448535.97861919
27,2,3,1,2,8,2002354.9769599,3487605.35017518
18,3,2,0,0,5,1476521.44705125,4465837.18809504
40,2,3,0,6,11,2137179.48637598,9213156.68234728
14,3,1,0,1,5,1711431.34425205,4913189.45620652
27,2,3,0,3,8,1537228.35456842,4461768.508433
30,5,1,0,7,13,1859456.62648079,6739199.8383085
39,6,1,1,2,10,2192035.19473119,6041302.44166015
32,1,3,1,2,7,1794002.5187455001,5735506.50628825
16,4,3,1,6,14,2216155.86656022,6661111.70291341
22,5,0,2,7,14,2968009.08393437,8869630.25884134
28,1,3,2,6,12,2861926.11152791,4118783.08728546
14,0,1,1,1,3,1578341.19208422,3110099.35120065
15,2,1,2,6,11,2043301.27617905,6648237.75428336
32,3,0,2,2,7,1380546.67083365,6504105.99838542
21,0,3,0,0,3,1532650.95032195,3572774.87608449
24,2,2,2,4,10,2437347.79191334,6011844.16310244
33,1,3,1,6,11,1962053.5204544,5329421.01995648
12,3,1,1,7,12,2175103.40057654,5980653.26585244
29,0,0,1,0,1,1008863.28146242,3919914.75779424
23,6,0,0,2,8,1485166.8863868,5219350.81305564
38,4,2,1,1,8,1433949.52991112,7183168.997697701
18,3,0,1,7,11,2351180.54763209,8137370.969956099
36,1,3,2,6,12,1977313.41256882,7218079.04069068
29,1,1,1,7,10,1961959.6153676999,6882798.61618801
30,0,2,0,2,4,1562024.31042723,3141080.09474904
35,5,0,2,1,8,2133299.0669009998,6332761.10388811
35,0,0,1,4,5,1575381.61221953,4017236.96009528
31,0,3,1,3,7,1687258.52511388,4447223.67983863
17,6,1,2,6,15,2600376.75902356,8148814.45696272
31,4,3,0,5,12,2197571.22412782,3982490.33459792
18,6,0,0,6,12,2344621.72187937,4838032.53349731
12,1,2,2,5,10,2536120.76780019,7680872.32269209
22,2,1,1,4,8,1670683.83765286,5734859.29322194
21,6,1,1,2,10,2088030.33073019,6096610.04972184
40,0,3,1,2,6,1620064.85010451,2301891.45172454
23,0,1,0,7,8,1026531.86418963,6830077.64343615
18,0,2,0,5,7,1666863.85944119,3679773.2280796
17,0,0,1,7,8,1383533.49305776,3207322.44454261
26,0,2,0,0,2,904531.6291319809,2361857.66766116
14,4,3,1,3,11,1921114.11909195,5645552.41527193
24,4,0,2,7,13,2702442.64860736,9815005.94704415
16,4,2,1,1,8,1478342.2792067,3497482.66258471
36,2,3,0,2,7,1223808.50332672,3744086.30744674
37,1,0,1,6,8,1839077.50089068,3939061.47203933
17,4,2,0,5,11,2206194.8214963,4703558.21545864
17,6,3,2,2,13,1988562.4412937001,7592215.17518737
37,5,3,2,1,11,2010045.87852431,10043899.9579666
35,1,2,1,4,8,2484468.80741813,4159495.54667316
30,2,1,0,1,4,1572269.70362608,3741237.67231567
11,2,0,1,1,4,1656324.15360795,6397282.3922539
40,5,1,0,5,11,1856221.98483163,5757660.58529046
15,2,0,2,7,11,1845059.61833271,7813306.38388633
19,3,0,2,7,12,2108588.35910179,8871879.60682387
26,1,1,1,6,9,2152095.17966646,8357436.87351592
38,4,1,2,1,8,2206015.5993012,3204196.89462011
15,6,0,1,2,9,2054385.92471016,6236811.16057709
29,3,1,2,6,12,2407070.44586563,5573565.32996138
23,4,3,0,3,10,2097211.74304349,6326955.35148972
35,1,0,0,7,8,1667632.15333185,6842084.60036167
32,4,2,1,1,8,1806128.16476795,3799100.05507967
10,5,0,1,1,7,1856406.02995438,3670639.45523079
35,6,2,1,6,15,2245170.95667798,5101929.22476277
24,4,0,2,3,9,1657130.15897081,6440085.834653201
18,2,1,1,0,4,1256233.79479139,3116433.43622938
33,2,2,0,1,5,1352948.93585824,10354492.2988138
26,5,2,2,2,11,1862641.52553966,4289668.02613716
40,5,3,1,2,11,1749706.43599174,7131788.52191615
10,4,3,1,5,13,2302824.94932657,8216131.50646968
13,1,2,1,4,8,2142971.42300808,4980578.64111733
19,2,1,1,0,4,934914.725078832,2704661.88177062
10,3,2,1,4,10,1818517.01552764,5133122.09919004
29,3,1,2,6,12,1657828.65754301,7735264.03140055
17,2,0,0,1,3,1456860.29121359,4974494.22830498
36,6,1,0,7,14,2589745.74073849,10396214.6517304
16,4,0,1,5,10,2099315.99823834,7769535.20607352
32,6,2,0,1,9,1984455.50383443,7422523.50497665
12,0,2,1,7,10,1948076.32448511,4198528.14991653
15,1,3,1,0,5,1236983.76166131,6245134.02073202
19,3,3,2,0,8,1832134.41111636,9855208.30769473
38,3,0,0,0,3,905673.0797730241,4841656.67686633
28,6,2,1,4,13,1678244.21774112,10523772.1310324
34,0,3,2,3,8,2417086.44371869,5356204.89518196
13,5,3,1,4,13,2239765.07574262,5910112.91870304
35,2,3,1,0,6,1494466.70610147,5032824.54838033
12,5,1,2,4,12,2067833.93784876,8475509.20415178
39,2,0,0,6,8,1944981.03559221,1168366.78166351
31,1,2,2,5,10,1908643.16529507,2153451.30039587
11,0,1,0,4,5,1306050.77166008,4528924.42394345
23,3,2,1,1,7,1522025.3650668,4088446.06885832
14,6,2,0,6,14,3033159.91057417,3607071.56346915
15,5,2,0,3,10,1264121.99391395,6192227.05689601
10,4,3,2,0,9,2369474.16764079,7218296.38729779
37,4,1,0,7,12,2817506.91303909,7560123.14210539
38,3,2,0,2,7,1378224.9764327,6236539.87427916
12,3,2,2,6,13,1726425.66567686,5507570.67812699
12,1,3,1,7,12,1992989.72247034,5130338.00799367
23,4,3,2,2,11,1901008.14099947,8397039.89618816
32,6,1,1,6,14,2681590.33660443,11280198.254136698
28,4,2,2,2,10,1278273.26078669,5858921.36844332
33,4,2,1,7,14,2367215.6046953,9519057.78799269
19,1,3,0,6,10,2193972.38556369,6334637.96404501
21,4,0,0,2,6,1353711.65423038,4081039.88792055
28,4,0,0,0,4,1377191.60364854,3957788.49379285
11,6,1,1,6,14,2386854.36955037,9225865.29696221
37,3,1,1,4,9,1778388.42064126,7389134.39114127
25,2,1,1,2,6,1656242.47683231,6055869.75148842
21,5,0,1,4,10,1718584.46116687,5800592.94049385
20,5,3,0,2,10,1616885.82058241,4853509.75076173
11,2,0,2,4,8,1632082.70607574,5541768.43933485
27,3,0,2,2,7,1634032.37664134,5386365.53062495
11,1,2,1,5,9,2270850.88074415,5137068.24518223
14,0,3,1,7,11,1968883.44528104,7104994.78093961
15,3,3,1,4,11,2130049.17848757,5833411.97578784
27,0,3,2,1,6,1475665.59970553,4153806.71547056
38,1,0,1,2,4,1509543.50515691,4414150.54692161
31,6,3,0,6,15,2111104.59304225,8024898.77559593
32,0,1,0,7,8,1919770.31027202,5736840.02383667
17,1,1,1,7,10,1784302.52269102,5492488.04521678
32,6,2,0,3,11,2091880.10969952,9505906.82242298
39,0,0,0,4,4,954933.694245685,4398816.06985634
19,2,0,1,5,8,1476407.05514475,3864209.34519037
26,4,1,0,7,12,2389026.77278552,5134999.38914687
29,6,1,1,1,9,1802308.29339929,5440855.37250206
38,6,2,1,7,16,3080074.28568229,7457203.91245311
29,5,3,0,5,13,2115793.77605428,6137384.84486485
31,3,0,2,5,10,2200561.57796205,5577552.22653844
10,4,3,2,5,14,2535051.21074439,7154819.54726811
23,6,3,0,4,13,2334452.77290371,7119158.87749311
17,6,1,1,6,14,3377929.50814174,4979084.17419543
35,1,1,0,6,8,1713736.98949827,3764757.69898453
35,3,2,2,1,8,1581942.52234968,5814421.34065849
36,1,0,0,2,3,1145414.72826151,1104170.40429883
38,0,2,2,7,11,1416256.07969045,2822432.52858883
10,6,2,0,6,14,2210498.81692889,5085845.14845612
19,5,0,0,5,10,2102498.27025419,7720672.1289644
25,3,0,1,3,7,1150053.45861748,7720044.19617484
15,1,3,2,3,9,1712466.70684271,5637892.4594234
39,4,0,0,5,9,1943902.67706052,9104015.395831099
28,5,1,0,1,7,1768725.1376297001,6520421.36235189
37,4,2,0,5,11,2495620.45300277,6690793.30334879
18,5,2,1,5,13,2196815.52549942,7887399.19663351
37,3,3,2,4,12,2369693.17133822,8193549.4342487
14,0,3,2,5,10,2292527.43217481,8581474.689302001
12,4,3,0,6,13,2820082.87977387,5813557.48602866
38,0,0,2,1,3,1327946.4161777,4100298.13304037
27,2,2,2,4,10,1754770.71005034,4813600.58510243
32,2,2,0,7,11,2455669.98768916,8276991.24179446
32,5,1,1,6,13,2487225.79602074,10022187.7174946
36,2,0,1,1,4,1258916.93588586,1955181.8856668
23,2,2,2,2,8,1811718.39281049,4884600.65765941
29,1,1,0,0,2,1074786.31229026,2650622.78904482
39,3,3,1,5,12,2202819.26270766,3870033.13786011
32,4,0,0,5,9,2055494.12304105,4919625.73463291
20,1,0,2,4,7,1384964.74510605,7420833.29235754
26,0,3,1,5,9,1691778.78695075,4425606.09446026
25,1,3,2,7,13,1747259.7123033002,10634069.550332302
38,0,2,1,3,6,1465028.49393283,8035448.62144746
29,4,3,2,0,9,1667863.52779568,6385434.36123496
39,6,1,2,1,10,1635735.94545045,6225934.38301696
22,3,2,1,2,8,1756803.80256482,4655523.76350742
32,6,3,2,7,18,2981193.07473825,6395325.56654038
13,5,2,1,4,12,2189255.25024411,5820698.1823285995
17,6,1,0,4,11,2593748.37941467,7415198.07271491
40,4,2,0,0,6,1651477.75435646,4163962.60474315
34,3,3,2,7,15,2621995.91746564,5306470.30400262
29,0,2,0,5,7,1760805.84785564,6487130.20789817
26,3,3,0,2,8,1871701.42683229,5753295.67515237
39,3,1,2,5,11,1904588.64634482,7081867.33384077
37,0,3,0,0,3,1347152.88040959,4247306.57431425
37,5,3,2,3,13,3091394.90811403,7230943.91299059
20,6,3,0,5,14,2389631.53048142,6606278.21060066
35,6,2,2,2,12,1804481.62596333,5599151.32141111
16,6,2,0,6,14,2669184.84645962,10024584.2690925
31,1,2,0,5,8,1688755.49747201,7364508.93578078
11,1,2,1,6,10,1972922.07336592,9096084.3237529
28,5,2,2,6,15,2198623.84971356,2845582.27264458
28,4,2,2,0,8,1579378.66445537,2898776.19149278
37,4,0,2,6,12,2615433.67013903,4028697.23327298
39,6,2,2,6,16,2246086.72979943,6426346.7358311
26,5,0,2,1,8,2038951.95431292,6448927.63173606
34,4,3,2,1,10,2227076.91529459,6692713.54770294
28,6,0,1,4,11,2428624.99910658,6497297.32794581
19,6,3,2,2,13,2716250.41539858,8500095.03950541
40,5,0,1,6,12,1820036.946157,6472020.45428407
40,5,0,0,4,9,1470083.11804911,2765999.87183234
31,2,1,2,4,9,2000497.28592105,6814798.5975016
33,3,1,2,6,12,1915278.07923639,5273036.35568532
10,5,1,0,3,9,2067840.04587457,6715683.17030785
36,5,1,2,5,13,3080994.33171778,9479648.26032416
32,1,2,2,4,9,2218524.85820305,6199338.60621552
22,5,1,2,4,12,2435953.43490433,3030477.85650484
31,0,3,2,6,11,1848006.85875315,6583982.9593678005
13,0,3,2,6,11,2178077.79180441,4751973.28229252
20,2,3,2,1,8,563249.316289035,7648819.21956611
25,2,0,2,7,11,2412207.69881776,5922771.38952822
26,5,0,1,3,9,1689709.39332942,6542059.50977616
28,3,0,2,4,9,2067553.33040383,4333315.50819149
16,0,3,0,1,4,1269210.4034348999,3017503.08504459
32,0,1,0,5,6,1994634.57025829,6232284.18136471
14,3,2,1,0,6,1875075.23804358,4241288.57300684
30,6,0,0,2,8,2144718.42166466,3834056.7163480003
40,6,3,0,7,16,2715294.13015368,8680169.57914329
25,6,3,0,1,10,1943093.64071207,6304512.77686033
25,1,2,2,3,8,1555193.0748744,5731854.72216918
16,3,1,1,4,9,2040602.75967049,5407601.57567513
36,3,3,0,4,10,2007003.21085007,3826788.78466227
10,6,3,0,5,14,2406585.26363122,5408035.34447146
10,6,1,1,3,11,1533811.88667476,7653946.13419847
38,0,2,2,6,10,1825801.19593598,7917190.89233555
30,3,2,1,2,8,2099474.38314753,5717493.56210023
19,3,1,2,4,10,1861269.88062232,8351624.84285828
30,3,2,0,2,7,2153435.31077474,1886083.04926293
32,2,0,2,1,5,1300376.96099244,3291784.50229359
17,4,3,2,5,14,2705774.60871502,1733975.94485986
10,2,0,2,5,9,1663246.50901398,5560696.30044146
13,4,3,2,4,13,2132913.07607038,6565794.17086156
33,6,1,1,1,9,2145312.43307966,6230607.10380515
34,5,1,1,0,7,1837694.13081991,4926476.7239384
33,2,1,0,2,5,1348652.56694982,5538161.77765824
31,1,3,2,3,9,1951868.09528709,4488564.14790244
29,5,1,1,2,9,2267728.78338207,4435280.91882312
28,0,3,1,7,11,2737968.52567941,5934160.23035031
23,5,3,2,3,13,1827546.77591324,9061454.69388379
35,4,2,2,0,8,1963175.17565661,6203842.92794657
37,6,1,0,1,8,1844911.443258,6649560.85654908
38,2,3,0,2,7,1792411.10800541,5426267.53796938
14,1,3,2,0,6,1722240.71881901,3762206.2193178004
14,3,2,0,3,8,1806341.92905026,1928784.31433128
15,2,0,2,1,5,1327965.38254432,5333039.00190344
11,0,0,0,5,5,1322689.77489385,4640197.35254513
17,5,3,0,7,15,2403028.89905847,7452278.248714
11,2,2,0,5,9,2107970.232795,6656516.05291127
12,2,0,1,0,3,1735897.94953644,5809631.91673309
39,5,2,2,6,15,2918393.46161385,5228393.9821802005
21,5,3,2,7,17,2370715.02526456,8296384.123707599
33,4,2,1,3,10,1996435.173923,7488119.65261742
22,2,0,0,2,4,1542753.95378307,3346978.80273724
19,3,3,1,2,9,2607634.5049291,3255086.04928017
31,4,3,2,3,12,2053556.37673178,7343828.08158899
26,2,3,2,0,7,2189629.31195603,6649705.40647134
13,4,3,2,0,9,1874731.71243409,2367900.78801207
10,2,1,0,5,8,1869744.16436816,8268940.51199315
37,5,2,0,6,13,3106497.70597637,2941556.01699448
18,6,2,0,6,14,1158017.76453646,5041938.11725966
34,5,0,1,3,9,1321323.60469504,5636514.25824676
35,5,2,0,3,10,1616384.34998544,7006478.81223522
29,4,2,1,2,9,2103658.40316893,4585865.66807688
18,6,2,0,3,11,2237169.38115124,4293780.77136758
34,4,1,0,5,10,2474425.00653391,7622144.43170391
32,6,3,2,1,12,2537535.10174875,9377818.35023993
20,3,3,1,5,12,1888727.44250817,4490176.99771928
12,2,3,0,5,10,1892665.64891312,5045567.54750924
38,2,1,1,1,5,1417245.05128252,5261898.06065895
29,4,3,2,1,10,2542270.45826554,5242584.47205726
37,5,0,1,4,10,1445115.73027658,3448618.40443531
26,2,3,1,5,11,2120414.87632931,5924722.0107734
40,0,2,2,7,11,1765614.23227571,2529449.70334809
14,5,2,2,1,10,2132295.9857481,8502495.77181552
24,5,3,0,0,8,1743901.35418425,4046877.81356538
40,1,0,0,4,5,1469341.04813314,2709651.81536062
23,1,1,1,0,3,1436754.45763771,4269504.12498953
39,4,1,2,5,12,2338827.81196647,7032672.03060917
21,1,2,1,4,8,1517928.73078955,7435135.82675099
38,2,1,1,3,7,1844182.59999963,4093858.43428563
29,2,3,0,1,6,1762961.58520201,5650166.41386331
32,0,2,1,6,9,2157375.18665919,9865880.84336292
28,2,1,1,6,10,2198244.66320698,4994731.21186772
14,6,2,2,2,12,2195716.29817449,4197180.89709509
35,0,3,1,4,8,1471796.72448516,6303691.02841907
11,4,3,0,4,11,1882838.69792287,3420753.87960588
20,1,0,1,2,4,1319140.05245694,1262508.64991281
29,1,1,2,1,5,1688869.36997996,4249390.18332942
28,1,2,2,5,10,1707105.30569176,4481015.8150963
22,4,3,2,6,15,2078290.44199254,4846728.84664295
16,2,0,2,2,6,1333654.31867932,6737288.6700085
29,6,0,1,3,10,2325402.83635705,7530905.66808012
39,2,1,2,4,9,1701580.94400038,6330569.54991036
37,4,1,1,1,7,1283356.15364464,5017724.39252876
12,3,2,1,2,8,1911113.37134722,6954553.05803679
21,2,2,0,0,4,1716889.32461083,1992913.60774479
33,4,0,1,1,6,2136252.8603204,7264120.39542836
37,2,0,0,2,4,1479829.52279051,3786518.43601086
35,6,2,2,5,15,1816696.42054116,12256929.943642098
16,0,3,2,7,12,1544678.86034157,7788022.68570276
18,1,1,0,1,3,1362922.02109811,4067952.47260349
18,5,3,2,6,16,2137883.40135046,3505341.95114314
33,3,2,1,4,10,1603014.64874419,5847709.47129127
36,4,3,1,4,12,1478708.89086768,5858245.33748789
24,4,2,0,4,10,1910587.35558534,4568838.10491202
21,2,2,0,5,9,2053995.58810703,4458606.33251081
37,2,0,1,7,10,2125745.83211771,5582659.27869097
10,1,2,1,5,9,1921878.53800056,6112105.4530237
25,5,0,1,2,8,1520675.8427453001,5317055.43402789
19,4,2,1,2,9,1535942.06698092,4289149.766393701
10,2,1,0,0,3,1267140.18059296,2787802.39405635
39,5,2,0,0,7,1753678.16718416,5110481.16255765
27,1,0,2,7,10,2505979.81792055,7066283.00172771
14,0,3,1,4,8,1669583.80818281,4402445.59199448
14,4,3,1,3,11,2668393.70947014,6769573.01540997
13,4,0,1,6,11,1730156.25708507,1941273.06450416
39,4,1,1,1,7,1449449.77926773,5939690.04520338
19,2,3,0,3,8,1706994.88471995,5606462.79686119
22,0,1,0,6,7,1560314.56397999,5686269.77033137
11,3,0,1,7,11,1996151.69099622,7479979.34021831
34,0,3,2,7,12,1871233.83018747,7722181.120099901
14,2,0,0,1,3,958327.5169305521,1114445.52440413
16,6,2,2,6,16,2974420.38015792,8796898.24653382
34,2,3,1,6,12,2208865.46519427,3999330.22116309
21,3,2,2,1,8,1462399.09912769,5570111.69383824
14,6,1,0,2,9,2173875.60952465,4388786.00444365
11,1,2,1,1,5,1246154.31620546,2347895.09691534
12,0,3,1,7,11,1963921.51279781,8158977.034735001
19,2,3,1,0,6,1149884.87268462,3982485.58171668
16,3,0,1,3,7,1792363.43184313,5835664.55530127
28,5,3,1,4,13,2548666.55953262,6678308.374584099
24,3,1,0,2,6,970279.292890497,1130542.27457995
25,3,3,0,7,13,2312326.803482,7278040.97306619
11,0,0,1,2,3,1114613.64270443,5080811.25046849
32,1,2,1,5,9,2123553.06973031,5542336.58270536
37,6,1,1,0,8,1693317.80652857,3152599.11138897
21,3,3,1,3,10,2048142.6577216,3999004.16833729
33,0,0,1,5,6,1340181.72484151,6827252.36278484
18,6,2,2,3,13,2694382.16403389,5615281.94301449
16,6,0,2,3,11,2128014.09451776,3386050.81889246
20,2,3,1,0,6,1420257.33624073,2603057.36890456
26,5,2,0,5,12,2627424.53040654,5783654.66831847
23,6,2,1,1,10,1976951.69112884,4496761.49443351
17,2,1,0,3,6,1846027.97675686,4029645.31987233
40,4,0,1,3,8,1532712.10137483,4407506.68392158
40,0,3,1,3,7,1626247.6840667,3408019.71106214
25,5,1,2,7,15,2713632.31213053,5808140.42508774
12,2,0,2,1,5,1428447.82034163,166770.818065744
17,4,2,1,5,12,1580444.02851079,4972221.18641466
37,3,0,0,3,6,1104890.62757186,5059404.7516082
38,6,2,2,7,17,2558066.01596874,9194137.71722012
15,5,0,2,5,12,3152118.20273276,5610800.85341927
23,0,1,1,0,2,1123829.94017075,4223918.72993621
36,5,1,0,1,7,1064110.50108549,4540337.79150412
38,4,2,1,4,11,1927955.9695376,7179439.74594736
18,3,3,0,1,7,1887490.6928165,4114023.8577676
24,0,3,2,4,9,2364433.53692899,6990336.61714218
15,3,1,2,3,9,1930300.2280602,4980386.57423915
22,1,1,0,1,3,1242970.3419317,6378523.06976576
39,3,1,2,6,12,2195365.03267742,6863236.01288477
29,6,2,0,2,10,2003733.74118292,6785333.10173146
17,4,3,1,6,14,1789328.51155288,9297722.52280576
17,2,2,1,6,11,2585641.8680457002,7560942.62090387
31,1,2,1,5,9,1577434.60896138,4435049.44880929
27,0,0,2,7,9,2103822.49470836,5236590.97360188
36,6,2,1,5,14,2513052.85112485,4860065.16336276
30,1,2,0,6,9,2033513.17762761,4643349.56482132
30,2,1,2,3,8,1282023.72040425,4604907.18083931
21,1,1,0,5,7,1406056.6517415,1833372.06825713
17,4,1,1,6,12,2512580.52175399,8593995.61979229
40,4,2,2,2,10,1745899.23951997,4195731.18986737
21,0,2,1,0,3,2110872.10048706,3408836.40933046
25,2,0,2,6,10,2070368.23923887,7030366.46492396
25,2,0,0,7,9,1472354.00431853,7949421.92595542
23,5,1,2,7,15,3169901.58600302,5649603.45045849
33,5,2,0,7,14,2800040.16350136,8645462.41640878
38,0,2,1,0,3,1007875.91443357,5103342.70976989
10,4,3,0,0,7,1490650.54158654,4726071.05124868
36,5,3,1,3,12,2130219.76799524,4338800.95645373
32,2,1,0,7,10,2016028.00728768,6602124.6478448
21,5,1,0,5,11,1895979.72225146,4565275.53799284
16,6,0,2,6,14,2648256.2514135,3204848.61411548
18,6,2,0,2,10,1824738.73623267,6430568.701170599
39,1,3,1,1,6,1683116.65887476,2533758.01237391
24,3,3,2,5,13,1991433.49696512,6820338.7354288
30,5,1,0,3,9,1833085.77416021,4465546.53550746
39,1,2,0,5,8,1843214.13976287,5081057.64055136
29,5,2,0,7,14,2434311.68677332,5533695.40461055
20,0,2,2,4,8,1900360.63846079,4357570.56065486
11,0,2,1,5,8,1738223.58075492,3653600.86149169
40,6,3,2,0,11,2361243.44387357,7035066.25330307
30,5,2,0,6,13,2936451.04880184,7581691.30987836
37,2,3,0,4,9,1627463.82242554,8051641.20113216
18,5,1,0,5,11,2325689.02112498,6564529.9233711
12,6,1,0,2,9,2056499.09042127,6479150.700062901
27,0,0,2,5,7,1552490.2609336001,6650846.51627032
25,5,1,2,0,8,1802480.85845393,7366778.57833378
12,1,3,0,6,10,1175077.13238993,4715219.31798945
23,0,1,0,2,3,1077493.22492559,4644713.79238393
27,0,1,1,4,6,1932273.13003713,2193900.52449356
12,6,3,0,2,11,2580721.75134791,5683465.64808438
14,6,0,0,6,12,2194181.11000915,5974872.92688598
21,1,1,2,0,4,1707657.42053946,5167722.49851894
13,4,0,1,3,8,2166211.92027606,8852488.31399367
28,2,1,1,5,9,1172326.17500236,5066161.26640449
19,5,0,2,5,12,2468450.7973446,3469377.25979906
19,1,0,1,4,6,1737298.20402018,5121269.83250271
21,1,2,1,6,10,2167309.69004527,1318742.05478465
21,2,0,2,1,5,1323280.34820032,3900163.47215546
34,4,3,1,2,10,2005467.03868004,3423133.56398899
30,4,2,1,2,9,2165968.06868901,6590635.4132330995
30,1,1,2,7,11,1956608.38916382,9698076.24681484
15,2,2,1,6,11,2304067.32202156,8751071.10448886
31,0,3,2,5,10,2025370.85594567,4413935.09246367
39,4,1,1,1,7,1319321.72494064,6691109.7996979
40,5,0,1,7,13,2745701.54526706,4331000.07603007
12,1,0,0,6,7,1768678.89467085,5189652.41962479
12,3,3,2,0,8,1657074.27052427,4354362.59754657
31,2,0,0,7,9,1282328.42085913,6636188.69778666
29,6,2,0,4,12,2016784.58805538,7791152.49394773
19,1,0,1,3,5,1443729.45593009,5378579.87033284
18,2,2,1,2,7,1425018.5565097,2630168.55536608
35,4,2,0,7,13,2034000.02554923,2329179.68794658
39,1,1,2,5,9,1807528.44622241,4317972.23083354
13,4,3,0,7,14,2011750.41165322,5027443.08961144
30,5,0,2,0,7,2017194.18573581,5215554.87167903
10,1,1,1,4,7,1451698.95162042,3761208.88720098
37,0,3,1,3,7,1590349.53528017,6046359.04561524
26,4,3,2,2,11,2160115.08072406,7336841.75973306
26,6,3,0,4,13,2564380.85261753,6728622.25036198
13,1,3,2,0,6,1432721.8734511002,5953584.7412547
18,0,1,2,5,8,1967071.82552969,5628978.31356747
37,0,1,2,4,7,1483639.88724011,5033807.08993427
37,5,2,2,5,14,2422716.09662268,7973758.85041289
29,3,1,1,6,11,2540561.62150079,6949275.33313024
24,1,2,1,5,9,1979455.34075449,5083905.32520519
26,5,2,1,1,9,2074768.51122146,7582654.77206231
31,0,0,0,6,6,1790817.10257494,4078931.52476148
33,4,3,1,5,13,2654298.2298312,7284615.48153119
18,6,1,2,0,9,1842397.84196849,6629013.14342672
25,0,2,0,6,8,1831523.81427866,8175278.80576771
15,6,1,1,6,14,1728599.12053075,7878854.89851869
13,2,0,1,1,4,1478280.31548109,3087707.34014771
18,6,2,1,6,15,2011554.9131643998,5104881.48904064
25,6,3,2,3,14,2606298.11582809,9620525.06600922
19,0,0,0,7,7,1469249.21781231,6466561.10596797
23,6,1,2,2,11,2040552.56861131,4412123.62777302
27,3,1,0,2,6,1755959.28843082,4989871.69436485
14,1,3,1,0,5,1389341.48542071,6372355.49226093
12,0,1,2,6,9,1942751.99519982,6467864.61010116
21,5,1,1,3,10,1986883.25096273,4615288.43957259
14,5,2,2,4,13,2636679.64232022,6828125.78647591
40,3,3,2,2,10,1827298.02913227,3189557.22309259
21,6,2,1,3,12,2258323.9021727997,8038417.46486146
37,0,1,2,7,10,1869829.65985936,3963751.4160848
14,1,3,2,2,8,1870132.18767997,6216761.69937774
27,1,2,0,7,10,2150050.09326477,5958761.88901324
13,6,0,1,5,12,2270638.27952574,5810027.21321534
14,2,0,1,1,4,1388332.26395145,2957203.42387796
34,4,1,1,7,13,2703498.23853401,8146234.59529267
25,1,1,2,2,6,1747155.30634583,6081752.85219502
29,6,2,2,7,17,2576970.37846513,9898716.37555557
40,4,0,1,6,11,2551974.02389017,10364831.408960499
21,5,1,1,3,10,1308652.43476089,5688794.18479873
11,1,0,0,2,3,1349802.51291422,3437139.47266197
21,6,0,1,2,9,1216548.34238117,6755433.72393077
10,1,1,0,1,3,1242178.09215381,5312550.76575716
17,4,0,1,6,11,2163119.30854978,6704518.49198198
13,2,0,1,3,6,1590373.8358143,4351410.31216033
33,0,2,2,3,7,1518425.94456107,4202227.59687992
14,6,0,1,0,7,1661546.62961282,1579045.76163706
23,6,0,1,4,11,1987177.21106345,5802039.64985567
14,1,0,0,3,4,994939.843499386,4186232.96429329
40,4,1,2,2,9,1908291.01945402,5755083.95216459
17,5,1,2,4,12,2044475.12482649,8246199.06064144
15,4,1,1,1,7,1685526.7295599,4814961.45274858
31,4,3,1,5,13,1948022.35234804,10331266.0657093
12,1,3,1,3,8,1466787.89412526,6651314.41943879
29,3,1,0,0,4,1375937.00500438,5029152.26279634
15,1,3,2,1,7,1790048.25741574,7340339.62862106
15,2,3,1,0,6,1855931.60971282,6434159.10792451
38,2,2,1,5,10,1723794.83319714,7304924.51052316
26,2,0,0,4,6,1766220.81339386,3793895.03315265
17,3,0,0,4,7,1453100.86358624,3752701.38309615
26,2,2,2,7,13,2375436.55155264,8430240.75113761
33,4,1,0,6,11,1790918.01629048,4935310.26413071
11,6,0,0,0,6,1507747.56418733,4738024.39247679
17,5,3,0,2,10,2127666.61110748,3137095.60563022
21,0,2,2,7,11,2323455.2491767,6042861.19485499
31,0,1,2,3,6,1470428.2758342,4227698.60022998
39,1,0,0,5,6,1239479.6859443998,6357356.85317308
40,1,2,0,5,8,1669310.56730257,7117797.41547022
11,2,1,0,0,3,1386124.13323471,3480925.6035375
21,4,3,2,2,11,1888174.5574848,4782319.94229998
26,2,0,0,2,4,1709370.26353319,5112595.30114818
19,3,3,2,3,11,2511508.16029164,4931608.98566782
13,3,0,0,1,4,1101153.03171118,3016146.01416101
14,0,0,1,3,4,1353864.85218243,7338964.19623779
36,3,2,1,6,12,2588398.27486059,6357214.03164811
15,0,3,0,3,6,1511543.78745909,4968053.40328015
33,2,1,1,3,7,1565390.85397641,4494100.27354017
34,5,3,2,0,10,2323337.63661019,8197158.85922483
18,2,0,1,0,3,1200493.74595203,4833070.31566453
35,5,0,2,5,12,2301621.44129579,3977988.13028876
12,1,1,2,0,4,1564012.48528467,5667535.11180119
18,0,3,0,1,4,1094890.412214,2666604.21779722
20,0,0,1,4,5,1643873.7128441,5066108.92604279
12,6,1,1,1,9,1759363.3100367,4640698.34289546
23,1,1,2,2,6,1605105.01171733,4603147.93494545
25,5,0,1,5,11,1873937.61982238,5086686.77680231
34,0,2,0,1,3,1459384.89533242,7480915.79423424
35,5,2,1,0,8,1845526.93947631,9322622.59703516
29,2,3,0,7,12,2311859.45067536,5055173.76166569
20,3,2,2,2,9,1829548.62500344,4898849.69964767
18,2,3,1,3,9,1816639.67097011,4605093.6994044995
38,2,0,2,4,8,2072510.16170706,6858436.62421498
34,1,3,0,2,6,1533972.33449396,5957889.87499819
33,6,3,1,2,12,2082886.72554528,3340538.15939587
37,4,1,1,0,6,1521801.52984724,6645775.1945767
15,3,1,1,4,9,2197096.74286097,6856391.800048599
33,1,0,2,6,9,1950221.35396278,6175166.93654468
27,6,0,1,1,8,1845729.90950386,7776148.88844474
22,4,1,1,7,13,2032728.66737275,4429446.58524139
13,1,3,1,4,9,1317662.77918478,2482806.0061426004
21,1,1,0,4,6,1183984.79361825,2409310.20907691
29,1,3,0,0,4,1656567.38816987,3839234.90156868
19,6,1,0,4,11,1963325.9401483003,7962809.14952411
12,2,1,1,4,8,1474733.41008845,6218540.65774649
13,2,3,1,2,8,1404801.54565743,6476864.16999972
34,0,0,0,2,2,814752.826864605,3912219.17214327
11,4,3,0,2,9,1865481.67795181,6743759.46882569
34,0,2,0,3,5,1365186.4939361,2384431.66972115
16,5,1,0,5,11,1748506.15291665,6081939.34962284
17,5,0,0,0,5,1740645.73095314,5150105.74825504
19,6,1,1,1,9,2059747.35634008,6540721.23745685
28,5,1,0,6,12,2252420.75976689,8118826.72527333
10,1,2,2,7,12,2783230.26712602,8030096.66068321
20,2,3,2,4,11,1888471.71023557,6837963.75385899
36,5,3,2,3,13,2702099.4715805002,4898034.62695063
32,0,3,0,1,4,983261.30597994,3727416.34152542
25,6,1,2,2,11,2103747.41354337,7333110.43582239
17,0,0,2,6,8,1825889.56324732,4364330.31536063
35,3,3,0,1,7,1781090.31117797,4371678.3784646
38,1,3,0,3,7,2008358.28644992,6381523.89778366
34,2,1,1,3,7,1450926.7561706998,6411201.154953401
36,0,2,1,1,4,1586018.85582723,2429270.93797038
25,1,0,0,0,1,954530.0878433429,5643101.48803201
18,3,1,0,3,7,1781048.98006898,5464569.99492097
37,5,1,2,0,8,1891870.74021134,3881218.18872616
21,4,0,1,4,9,1827651.14060186,4750502.66565451
27,6,3,2,2,13,1997451.50973765,7006492.52665262
35,2,2,1,4,9,2232131.43218108,4806193.11121185
30,2,2,0,0,4,1318176.39093634,3093697.40223314
27,0,2,0,4,6,1665945.89463337,3714822.36634493
32,0,3,0,3,6,2053201.72630914,3265763.90651919
20,5,0,2,2,9,1829416.33311556,5525428.72588366
14,3,1,2,3,9,1977165.79925345,5861921.26496534
24,1,1,1,7,10,1920586.30593058,6059676.56232765
27,5,0,2,7,14,2432946.73176041,9198780.65931807
34,1,3,1,4,9,2274348.45533853,3649893.99838383
30,4,1,0,6,11,2616615.3445316004,7522289.770167999
10,0,3,1,4,8,1568575.75308592,3992959.54259152
21,1,3,0,3,7,1690546.85865896,3340758.58618931
37,0,1,2,2,5,1415893.90973089,1454285.14233913
39,3,0,1,3,7,1508257.22953532,7124378.08436709
35,4,2,0,7,13,2440233.45560509,5057679.58433903
17,1,2,0,0,3,724424.3424430371,2829727.27711353
37,1,3,0,3,7,1397607.44144194,5572752.03847037
10,2,0,2,2,6,2090392.21494903,8682615.482941499
35,4,2,2,5,13,2567504.14729895,5205927.04789725
35,4,3,1,4,12,2300083.79095497,6281491.50440034
17,3,0,0,3,6,2098622.10473535,3848366.38834945
30,4,3,2,7,16,3174937.59169597,8310078.25131056
26,0,1,1,1,3,1673385.33235327,7596387.11464162
13,1,3,1,3,8,2090991.01590522,4387256.95476851
19,0,0,2,3,5,1963899.23661633,4521796.49526279
31,4,3,0,7,14,2404597.91860922,8431601.16623146
28,3,1,1,6,11,2424340.99417883,9102773.76720229
18,4,3,1,0,8,1489107.79744875,6623318.88292859
36,3,0,1,2,6,1555683.97070748,7346848.1003046995
40,6,2,2,5,15,2671910.04322127,4958335.21172707
15,6,2,0,6,14,1887402.91719028,5703687.154171499
35,0,0,0,2,2,1554801.06205208,1740676.77065614
19,0,0,0,7,7,1725030.38965982,7057079.540812401
12,6,0,1,0,7,1342967.80652956,3849098.16669796
20,4,2,1,5,12,2247710.91682283,8010197.97048375
29,2,1,0,5,8,2217956.26687635,3401409.42523697
33,2,1,0,7,10,2467572.08153794,6283184.06233156
20,1,2,0,0,3,1012065.28215125,4180892.93711542
26,3,0,1,0,4,1451924.01155603,3121851.79397608
16,0,2,0,1,3,1408335.00267581,4748537.38969827
25,6,0,2,0,8,1586991.41428476,6736295.93850212
25,4,3,0,5,12,2234817.45487287,7039710.56513932
14,6,0,2,6,14,2186723.69398645,7688241.68561293
26,2,0,1,2,5,1242580.34257076,4850197.2489194
40,0,3,0,5,8,1384448.8006224,4822539.61141842
27,6,0,0,2,8,2247325.37316441,6336759.07430082
31,4,2,2,6,14,3255779.43501849,7980780.23711515
13,4,0,2,4,10,1804681.46562881,3974804.20265192
15,2,1,0,2,5,1299706.98989638,2591505.21207018
27,6,0,1,5,12,1992081.0494636002,3278880.51514595
22,2,1,0,2,5,1691930.0441283002,2923202.76015258
28,5,2,1,2,10,2036455.88107195,5469863.31731534
24,6,3,1,2,12,2213394.36588409,9144052.20624006
24,4,3,0,4,11,1865427.48012112,7085438.8157758
21,3,2,0,3,8,1934867.53058117,4973312.16718235
28,5,1,2,6,14,2583172.41884525,6567312.85229309
25,2,0,2,7,11,2462007.3370631,6466731.71257921
19,0,2,1,0,3,1046401.91821702,3047626.01334784
17,2,1,1,0,4,1182013.79330132,3124357.89834727
37,6,0,1,2,9,1837416.44178889,4795458.68759877
16,0,1,0,2,3,1991719.22299943,5318119.84486074
28,2,0,2,6,10,1901434.86433892,4622582.31496236
19,3,3,1,6,13,1896193.32963572,5512908.72799178
32,5,3,1,0,9,1932124.46170329,4555021.1980497
14,6,2,1,5,14,2262454.18207888,6617689.14897624
17,5,2,0,2,9,2051392.55161092,7311980.81340797
20,6,0,2,4,12,1903854.40962664,8266597.38440694
21,1,3,1,4,9,1786252.62799645,9370687.96532271
18,3,3,2,0,8,1682175.51470746,5456940.31994479
25,0,0,0,3,3,1131893.67012786,1716332.61996051
27,2,2,0,5,9,2012365.79848593,8397363.10267203
36,5,2,0,3,10,2095604.50020563,7981213.68448883
37,4,2,1,7,14,1973092.13294598,7571252.19910099
37,0,0,0,5,5,1509695.20296395,4834738.09980493
24,6,2,0,1,9,2114087.02353156,7019340.35957807
23,2,1,0,0,3,1185582.66180711,5163138.12568762
17,5,0,1,0,6,2023204.91114152,6987744.03746253
26,2,3,0,0,5,1891445.01507187,5657400.56285204
36,3,0,1,5,9,2045041.25865801,7136855.89669991
24,4,0,0,6,10,2155516.67707181,6545432.01490732
23,4,0,0,5,9,2200130.76032617,8841886.17279298
16,5,2,0,4,11,2228492.33494884,4583299.96831176
39,0,1,2,1,4,1657179.6381982001,3528098.71651944
23,3,1,0,0,4,773930.5590883441,5409169.64306451
27,0,0,2,0,2,1153079.31468694,2007320.80681198
36,6,3,0,6,15,2781175.38965206,4819049.98408083
27,2,3,2,3,10,2079034.43198522,6218432.19098348
34,0,0,1,4,5,1475451.37160481,6054401.98643426
12,0,0,1,3,4,1355421.12942637,3626194.4372238
32,3,2,2,4,11,2077459.22449114,4961639.88726472
21,0,2,0,7,9,1213654.45697077,8128841.98787409
22,2,2,1,6,11,2370856.74768907,4006971.09889367
39,2,1,2,6,11,2179506.48263825,5707478.55195957
32,6,0,1,0,7,1319331.31267172,5172689.00844209
26,3,1,0,2,6,1904438.46776993,2373366.68300437
18,2,1,2,1,6,1289977.30713822,6138512.1817119
25,4,2,2,5,13,2523709.36318884,8089856.72898354
32,5,1,2,7,15,2389277.91314507,8044810.03786689
11,2,1,0,5,8,1874001.27435625,4475434.44800846
37,1,1,1,6,9,2168506.20363233,7915272.38957267
36,6,3,2,1,12,2114799.27196782,8589442.38183118
18,4,2,1,0,7,1736179.91383844,5647676.90208794
34,0,0,0,5,5,1330779.44151909,7900873.17059515
16,0,3,0,7,10,2203995.12962215,5182968.23556956
20,4,0,2,3,9,1660955.97110741,6503467.14017054
37,0,2,1,7,10,1585447.31487599,8337413.15117928
36,0,2,1,4,7,1135038.90761149,5610304.59593212
34,2,1,2,7,12,2274491.47318205,3341810.91793256
30,2,0,2,6,10,1897577.57620768,8379821.75267826
22,5,3,0,1,9,1947555.67995878,4372234.51928549
20,5,0,0,6,11,2141938.96180124,8207466.36572943
11,1,3,2,0,6,1636195.74579556,3452751.38886433
11,2,3,0,3,8,1804029.86906383,2010911.8893531002
22,4,2,0,6,12,2778648.15596461,6793179.38011444
19,3,1,2,7,13,2630501.6033683997,9274684.14517745
27,4,1,2,4,11,1120576.27291155,11114685.6263042
18,6,2,2,7,17,3417444.35768546,11813545.2995661
28,4,2,0,5,11,2199512.58790937,9388962.08784286
15,1,0,2,4,7,1774563.97297136,4867230.18096758
19,5,2,2,5,14,2480429.75088481,7612977.48589335
27,2,1,1,3,7,1886919.45242177,4971525.29057341
23,6,0,2,0,8,2166221.71505762,6806073.64550067
20,3,2,2,3,10,1558585.38494747,6492997.82105024
26,6,2,2,4,14,2277623.56347763,9155889.76818173
27,1,2,0,2,5,1741127.27385121,5605629.93108503
34,2,2,2,2,8,2110098.25113195,7601481.738501401
13,3,1,1,7,12,2646907.09825132,4372792.69819932
21,4,1,1,3,9,1809049.05326833,6405664.26084508
21,2,0,1,7,10,1985626.38103087,4163776.73417932
12,2,2,0,4,8,2116835.7812277,7674176.99253916
27,3,0,1,4,8,1377692.50715594,6568804.49962586
19,3,2,1,4,10,2137364.41122582,3187387.66025017
36,3,0,0,2,5,1557937.66700684,7093935.30230531
26,4,3,1,2,10,1618198.8013969,6187396.53672002
36,5,1,0,5,11,1895128.54975666,11260626.0610932
14,1,0,0,4,5,2082994.55960067,4829737.33188823
23,0,1,1,4,6,1669422.61142825,3205822.46765449
15,5,1,0,2,8,1846521.93007595,7232123.77319319
20,1,2,2,1,6,1711226.71238994,3791006.33346526
10,0,2,1,5,8,2229377.63074699,6902336.95476579
28,1,3,1,0,5,1319944.48154136,3034721.49850904
33,2,2,1,2,7,1523287.2360411002,3935678.75663815
12,4,3,0,0,7,1932994.11335255,3438240.47751716
34,4,3,0,6,13,2791276.69373115,5943591.58005805
24,2,3,1,7,13,2975634.62826367,9789491.83132602
15,5,3,1,5,14,2262634.34366573,5417422.4349858
35,2,3,1,7,13,2671637.77137353,4128622.59211195
13,2,2,1,0,5,1429451.83596224,6496628.20912205
18,3,3,0,0,6,1105197.81689262,5013045.245810599
31,1,3,2,6,12,2250762.55843859,7716731.48065689
38,2,3,0,3,8,1694525.79715389,5017523.271811
18,6,3,0,0,9,1634164.63201958,3468950.21756818
18,5,0,0,3,8,1493099.35153202,7120294.71292416
25,3,3,2,6,14,2674603.62746858,4086923.80494073
17,2,3,2,2,9,2027783.69931075,6615615.43981954
27,1,3,2,2,8,2364262.13937519,5715917.39571404
26,3,3,2,2,10,1938988.7125895,5535576.16780926
15,4,0,1,4,9,1747952.67842525,7292997.87425094
25,3,0,0,6,9,2172923.87347776,7203203.17887429
25,5,2,1,5,13,2123800.93198449,6400746.71193494
16,5,1,1,5,12,1608627.80499236,5461441.37945881
38,0,3,2,2,7,1592784.64715586,6289216.46594617
33,2,1,2,5,10,1921811.96581495,6156524.55361231
40,1,0,2,0,3,1121183.79789401,4189701.13761472
32,4,1,0,4,9,1954039.86953278,4629313.55554086
28,3,2,0,0,5,1723859.836769,4218982.87953484
20,5,1,0,3,9,1768939.26707362,5690570.89830721
24,3,1,0,2,6,1382610.3236015,5896634.48828606
15,3,0,0,7,10,2391307.55806704,7030692.25677634
24,1,3,0,4,8,1732105.04529303,7264760.95677141
27,6,2,2,6,16,2565738.28054661,5269254.27022426
32,1,0,0,5,6,1453746.18884358,5255220.78775448
35,4,3,1,2,10,2008087.53250695,6619545.74479275
24,5,1,0,4,10,2019501.95804915,5881307.3613923
39,1,3,2,7,13,2268194.42038398,5322488.53616993
23,0,3,1,5,9,2030705.54300716,3955563.90856087
13,4,2,1,3,10,2199471.0473932005,4055734.73807108
28,0,1,2,6,9,2197440.28211439,9265858.76514527
16,5,2,1,4,12,1964692.74647189,11101887.2159692
30,2,1,2,5,10,2018332.01571806,3984523.92613892
31,1,0,1,2,4,1357726.80316031,5666928.75427735
39,4,0,2,5,11,1719002.83491132,4152712.61205703
21,3,3,1,4,11,2078549.30250203,2282002.68859632
31,5,1,0,2,8,1761118.01977892,4163314.09146087
13,3,1,1,2,7,1699402.51510636,7724802.56106319
34,2,1,2,2,7,1897703.62489486,7453752.11829208
19,4,2,2,3,11,1860765.90032282,8691889.44787496
23,3,0,2,3,8,1437008.50715274,6904759.85952259
12,0,2,2,0,4,1588604.31633906,5123299.87958443
16,6,0,1,4,11,1955285.36474747,7614652.69567839
28,5,3,2,5,15,2320692.36850482,5691140.6422475
18,4,1,2,1,8,1349088.79222288,3505286.85618096
29,4,1,1,1,7,1497564.47777379,8349157.26768375
28,3,3,1,6,13,3254293.07116852,9229043.05464131
29,5,3,0,0,8,2135868.69127695,2130513.72133272
18,0,2,2,2,6,1309759.22135615,5644363.00525958
34,6,1,1,5,13,2012702.6502669998,5043886.23005328
12,2,0,0,2,4,1509654.44170645,6116965.20814581
18,3,1,1,7,12,2272129.11931664,5404205.37273236
22,4,0,0,1,5,1414613.36659245,5699664.61869022
25,4,0,0,0,4,1901473.44941926,5047522.82465645
40,5,0,1,7,13,1872839.94614462,5233466.16059287
16,6,2,1,1,10,2059605.04028159,7262868.67925839
24,1,2,1,6,10,2024446.06908338,3801758.1694301004
40,2,2,0,6,10,1083633.49483816,7281688.18474371
10,5,3,2,6,16,2250165.95872572,5606148.55524082
11,2,3,0,0,5,1468870.69804676,622043.543814749
40,5,0,1,1,7,1467546.51786127,6153194.09205981
22,1,2,2,2,7,2324189.49485505,5623478.82220552
19,0,3,1,3,7,1385908.70368531,5813580.80466129
18,5,1,0,0,6,1665508.19994808,1665508.19994808
23,5,2,0,6,13,2625178.22632512,6926594.66587298
39,4,0,2,4,10,2241485.5029358,3852515.08970648
11,2,0,0,1,3,1284448.65192978,3536570.36950614
14,4,1,1,4,10,1550542.68319838,2899758.35563358
35,3,1,1,0,5,1969950.3724049,1152956.26508332
11,6,2,2,7,17,2730998.69178475,3898412.60149474
26,1,3,2,4,10,2094012.30749219,5078418.1415711
17,6,2,0,6,14,1625292.32575151,6363142.96935187
32,0,3,0,6,9,1795649.89301611,6644556.57226566
33,2,0,1,6,9,1641913.86991349,9385194.77180509
32,1,0,2,7,10,2148311.72144612,7817081.17557902
27,2,0,1,7,10,2093142.1601953998,6127997.46364467
38,0,3,2,4,9,2443229.46486678,5415300.67117632
30,4,2,1,3,10,2350279.85307443,5536999.28226423
31,2,0,0,2,4,1508636.75200311,2893886.69470744
40,6,1,2,5,14,1844782.95507953,7048695.252839
40,4,3,0,7,14,2874098.70444043,4270392.6559769
33,5,3,2,3,13,2343053.00772883,6811680.33082725
24,0,3,2,6,11,2161087.05705831,8543100.26373721
34,4,0,0,6,10,1992410.24988904,2525979.4315130003
10,3,2,0,1,6,1927886.79955816,4846624.70134625
11,0,1,1,6,8,1831289.71472499,6604541.19236621
38,5,1,0,5,11,1474075.91022121,10780482.5366418
38,4,2,0,5,11,2318344.91860823,5261432.52423778
11,6,0,2,4,12,2197880.75181988,6774267.60352025
19,3,0,1,7,11,2730865.20713627,5341803.24668453
30,4,0,1,6,11,2469447.1628787997,5786140.95902052
34,0,2,2,6,10,2136664.40164049,4518717.26664215
28,5,1,0,4,10,2328334.58299102,3961907.26092841
23,2,2,0,3,7,1679745.76247854,4924521.68939532
16,6,3,1,7,17,3161441.74449826,10317128.5753074
29,1,1,1,7,10,1927586.13894528,7262267.07364629
30,1,0,0,6,7,1733167.06317418,6763676.15161584
27,5,2,2,3,12,1656175.12305045,7184742.01342634
32,5,3,1,5,14,2694043.55234072,2197380.6955096
18,0,3,1,5,9,1929322.38667438,9604750.27861496
27,5,0,1,0,6,1518798.00385484,5403660.81102412
28,3,2,1,6,12,1700448.91542503,8837552.04861813
28,3,2,2,4,11,1404085.34035606,6583640.3164812
14,2,1,2,7,12,2081799.28910175,5518155.61616585
17,0,1,1,5,7,1594504.7296467,1639184.16737911
19,6,3,1,5,15,1909653.36037322,7022944.78935557
14,4,2,0,6,12,2761768.4457391,6199939.5027821995
18,5,1,2,4,12,2262889.98191865,7478714.71479166
31,5,0,1,1,7,2239111.99072837,4558732.97472641
11,4,0,1,4,9,2235743.24761357,4569366.06942205
36,6,1,0,3,10,1545899.96242452,2321839.47903583
20,5,2,2,4,13,2528642.29984557,5104385.6503343
12,3,1,2,6,12,3102461.98986795,10035129.4710487
40,1,3,0,4,8,1609475.18912516,5928328.14916643
36,3,1,1,5,10,1790840.72895227,5905555.75285891
25,2,1,2,3,8,2172720.47941659,3769207.42531621
20,3,3,1,0,7,1812550.56046562,5824629.9752446
33,5,0,0,5,10,1490163.30292925,3881295.55319222
39,6,1,0,7,14,1903051.66718722,10614152.7954142
39,0,2,2,2,6,1580216.5583574,4553316.71568441
11,5,1,0,5,11,2042937.3144126998,7963102.02663804
10,2,2,0,0,4,1268430.6600108999,4567571.33425426
37,0,1,2,1,4,1355390.90720046,5143514.82369717
31,5,0,0,2,7,1719637.46073632,4090119.43769271
33,5,2,0,4,11,1972099.00696087,7233985.44834722
35,3,1,0,5,9,2036893.41636286,3094850.05035585
30,1,3,1,0,5,1508541.53463887,3658556.15538016
39,1,2,2,6,11,2272923.82693385,4279107.28523055
35,6,3,1,2,12,2117448.43952906,6713118.32606401
15,0,3,1,4,8,2041371.44146645,6414730.16065277
21,6,2,1,7,16,1944373.43053195,7809680.330585901
33,1,0,1,5,7,1531116.56689817,5760671.02253719
27,3,3,1,0,7,1485177.54356755,7418277.1663683
13,6,3,0,1,10,1900258.40952655,2518183.18042162
27,1,0,2,6,9,2114981.29611973,8032519.09449955
39,3,0,2,5,10,2000837.36824855,4999595.57523024
30,3,0,2,5,10,1807399.35968821,9087498.23627353
38,5,1,2,1,9,1939196.13141145,7936364.9665118
24,2,1,1,6,10,2294460.98524153,7135664.83834753
10,5,0,2,6,13,2308438.0539897005,5289890.14257552
33,0,1,0,0,1,1282954.87764699,1974478.63605285
28,4,0,2,6,12,2544616.52493553,6520131.40365025
26,3,3,1,2,9,2120261.62918929,3652663.29624665
28,5,2,2,0,9,1764536.58432226,5574483.28677913
24,1,1,2,0,4,900839.6727022791,3698229.34149522
18,3,1,1,6,11,1889503.6134305,6585050.83836672
30,6,3,2,5,16,2879727.7667948,8313582.94382402
35,0,0,0,1,1,1268739.80991035,3070920.98184649
10,5,3,0,0,8,1997498.0247884998,6112183.09433182
27,5,1,0,3,9,1921465.78853426,6204668.20848309
12,4,0,0,0,4,1352459.99019719,4174670.54554737
28,4,1,2,6,13,2005236.25045335,5742549.20864883
12,6,3,2,0,11,2071072.89366752,6270937.24632374
24,5,2,0,4,11,1941548.10253153,7871792.98394025
31,1,1,0,5,7,1189518.39687958,4789833.76267388
19,0,2,2,5,9,1945812.45612758,5934150.79419661
38,6,3,0,5,14,1751342.60309785,8567856.74840024
40,5,2,1,6,14,2168813.96950034,7174271.53294453
12,1,3,2,1,7,1618969.05321764,4509231.51783846
17,6,1,2,3,12,2354585.8869417002,6794673.41412728
30,5,1,0,0,6,1650526.21631866,5744215.76191744
24,4,0,2,0,6,1639555.53342659,1941308.2793265
30,6,3,2,1,12,2348273.63360741,8449101.54155736
15,1,1,2,3,7,1722322.45357617,3470793.72345779
32,1,0,1,0,2,1338975.00668112,2500322.02499525
37,3,2,0,0,5,1241588.68185115,4535888.20839716
19,4,2,0,5,11,2285198.25905175,8899198.68417207
28,2,2,0,7,11,1603908.71726782,7591690.51155719
21,3,0,1,3,7,2021432.18447724,3258709.40633583
15,0,0,1,1,2,1599948.63426099,1279617.48977074
16,3,1,2,4,10,1699313.22478055,7305663.76406939
24,3,1,1,4,9,2113440.78558161,4488191.5768468
21,1,3,0,5,9,1375871.62986966,5914432.84015414
19,4,2,1,2,9,1592487.19179052,6813092.54201394
36,3,2,2,0,7,1756284.73980076,3189123.91498101
35,2,0,1,7,10,1995147.67287512,6907347.659114099
24,5,3,2,1,11,2348434.9127126,4506146.46511161
25,1,0,2,2,5,1257163.61841702,5161750.97408581
34,4,3,1,3,11,1836100.58347221,5162733.80137969
13,2,2,1,0,5,1354221.7229004,7306525.74285345
14,6,1,1,6,14,2327070.72353074,9166003.05657268
14,6,2,0,0,8,1891968.86881544,5242591.44058783
40,5,1,0,2,8,1675281.7571837,4414427.71287227
24,4,0,1,2,7,1893228.93769945,7451029.67580725
25,6,3,2,6,17,3526829.19013645,11726125.341481099
16,2,2,0,3,7,2114688.47302264,5994054.05000097
27,5,3,2,7,17,3364429.61189162,4960264.17490711
28,1,1,0,3,5,1936113.79888061,3418517.31003742
36,1,3,1,1,6,1765702.5661471002,4935825.91464946
14,2,2,0,5,9,1357599.50261208,4702948.76209977
20,6,0,2,7,15,2240057.67397238,8967043.066579599
23,4,1,1,3,9,1951702.79758489,6567091.24120569
32,3,2,0,5,10,1482953.63077202,7380796.29458892
27,5,2,0,5,12,2321705.45800982,8736894.22097818
37,3,3,2,1,9,2074235.37317068,5444285.19395496
28,3,2,2,1,8,1619365.07044534,4857641.35802613
35,6,1,1,5,13,2453980.33860661,6088163.99348593
19,3,0,2,0,5,1957287.8837939,3725048.41694189
40,1,3,1,2,7,1375136.50264278,6209988.38251842
36,4,1,0,2,7,1903977.01296595,1586002.16006162
34,3,1,2,5,11,2348404.66075037,7388149.43554664
40,4,3,0,1,8,1437381.36663841,7276340.31473211
19,0,0,1,7,8,1916285.27996723,7849967.91403524
39,5,1,0,3,9,2188237.59207383,6130407.00610602
34,0,3,1,3,7,1601515.67953127,5653617.35361088
10,4,0,1,0,5,1423482.33061293,5090355.35559693
34,2,3,2,5,12,2190468.33343741,8848428.53667576
10,4,0,0,0,4,1557244.86772482,3402738.14369115
24,4,3,0,6,13,2257974.15111824,5251301.26544944
11,2,3,0,1,6,1355295.83804889,4398997.76117701
17,4,3,1,7,15,3306281.14023578,4913775.90156058
28,2,0,0,3,5,1257042.21563699,3876314.07915214
25,0,0,0,7,7,1763982.73089198,7252215.41904666
19,5,0,0,1,6,1587791.29544339,4939322.93380248
27,6,1,2,3,12,2317404.61760196,4950210.872521901
32,4,3,1,0,8,1423826.91945591,5036927.72683294
31,4,0,1,5,10,1741511.80279819,5854874.49928514
36,3,0,0,4,7,1945757.69398907,4721012.9802829
23,1,3,0,4,8,1919346.28470878,3427177.94964274
25,2,3,1,1,7,1354219.00626349,4595048.95729895
37,5,2,1,5,13,2608045.26986108,10502520.6662264
26,5,0,2,5,12,1652928.03462672,8909206.83391374
36,4,2,2,6,14,2315910.64305042,7064820.79478997
37,4,2,0,2,8,1160034.10657413,3340723.82912248
33,4,0,0,3,7,1642606.01893752,4848950.65667118
39,6,1,2,2,11,2633430.49956427,2584897.03548694
13,0,3,0,3,6,1456701.40309077,5216262.78501258
24,0,0,1,4,5,1799497.6408656999,5062246.99227664
23,5,1,1,5,12,2782371.52665727,7420044.633493801
17,3,1,0,1,5,1323740.65909715,3322099.24007809
20,3,0,1,2,6,1201332.83927165,2962342.94471603
37,5,0,2,6,13,2270654.1702703,7058731.09105453
36,5,3,1,1,10,2461271.55691674,5689714.156615901
15,5,0,0,7,12,2615622.6634336,5331536.12007027
33,6,2,1,1,10,1646694.14067786,3953317.2704224
37,5,3,1,3,12,2033229.46735948,2213893.45974874
11,2,3,1,4,10,1654044.24030238,7340073.25402271
12,3,0,2,1,6,1446345.31261189,7132578.96963869
25,1,0,1,6,8,2303766.69864778,5771620.76456607
31,2,2,2,3,9,1723062.53275825,5254899.11007962
30,6,1,0,0,7,1813488.51098447,4731790.84460216
39,4,3,0,4,11,2271424.9288252,4383475.89486866
24,5,0,0,5,10,2108345.68736256,3198703.67741187
25,3,1,2,1,7,1373749.00336713,4924043.62802577
27,3,3,1,7,14,2761962.65956293,6757144.72344154
18,4,3,1,6,14,2694817.18148302,8763797.41740933
20,6,0,1,1,8,1301151.89262137,6141097.44484882
36,5,1,0,5,11,2388930.55598585,5040960.25603287
14,5,2,0,0,7,2247714.10167271,6398369.88226283
29,3,1,0,5,9,2657370.28516344,6048178.82231717
11,0,0,0,7,7,1919167.58470166,4462438.06163957
22,5,1,2,3,11,1521116.98967952,7292770.57954854
13,2,3,1,6,12,2277903.68883517,4803388.51065029
30,2,0,0,4,6,1386614.69689475,3962852.37032878
35,6,0,2,2,10,1459049.01662905,10308210.8495731
21,4,1,0,1,6,1751130.71081903,4923897.75791743
37,3,2,1,7,13,2582373.49209189,1554926.69750082
31,2,0,1,4,7,1663156.66757832,8008389.55678979
28,0,1,0,0,1,1174638.94901366,3569147.54361971
30,5,1,1,0,7,1765355.53356478,3806010.83512896
34,1,2,0,4,7,1671936.37502201,4796822.99189025
31,4,2,0,3,9,2358747.51886474,5845990.01050679
20,3,2,2,0,7,1873702.27096548,6819341.10046623
21,6,0,0,4,10,1940804.12648094,4965072.22360308
27,5,3,1,1,10,1991550.52987742,7221177.18894918
39,6,1,1,2,10,1144380.01925369,4034338.21287752
19,3,2,1,0,6,1616164.76157256,4731879.49583233
33,1,1,2,7,11,2296962.41933417,4890605.74849784
12,4,2,2,1,9,1555324.48915821,2669616.72592596
30,1,3,1,0,5,2114294.00781166,3723558.54281319
36,2,2,2,6,12,2321586.27517619,8823700.552654801
39,6,3,2,6,17,2129474.67419523,5879370.38213438
38,4,2,2,2,10,2297509.79254976,8097453.64474011
22,1,2,2,2,7,1904714.08423863,2897494.20141065
19,5,1,0,2,8,1676897.7231141,8861638.25403302
37,2,0,2,4,8,2256145.91107525,5833539.68665382
31,2,3,2,0,7,1775038.01370349,3094025.4507134
12,2,3,2,5,12,2547137.66670295,7226786.94582144
23,6,0,0,7,13,2386055.46165668,5077273.19995194
20,2,0,0,2,4,1311154.76423511,3189901.80442764
19,6,3,1,3,13,1876019.43306391,5770123.6217808
19,0,0,1,3,4,1657308.12489092,6404851.96289253
15,2,3,0,1,6,951582.688351557,6478748.51563751
35,4,2,2,3,11,1868535.50077483,5720426.13505463
11,3,0,1,1,5,1184324.7462201,7400711.06081378
11,0,0,0,7,7,1631210.07356877,7090542.15219153
23,5,0,1,3,9,2575053.96643576,5706833.22359406
23,1,0,0,1,2,1101822.82155565,407407.400457132
26,0,1,0,1,2,876098.54522499,3066111.3391019
20,5,2,2,1,10,1352119.17607733,5339339.96767017
35,2,2,2,1,7,1805956.32255125,6051972.96090843
12,4,2,2,1,9,2010370.79713688,5707182.89286885
32,1,3,2,5,11,2630963.90605463,6640809.21279971
17,1,0,1,4,6,1661366.21018222,6761998.00373388
28,3,0,1,1,5,1553164.91344144,4709875.18962341
33,3,3,1,3,10,1900976.00541093,3368398.00130196
18,5,1,1,6,13,2823012.93680509,7228086.48141389
25,1,0,2,0,3,1263013.58788366,3213985.58291299
26,4,3,2,0,9,2090805.60289687,7034523.64029779
14,5,1,0,1,7,1216706.60881506,6059128.05877385
17,6,1,1,5,13,2209400.58734255,5518941.84729939
18,6,3,1,3,13,2428027.59496303,8154507.50160563
17,1,0,0,6,7,2215438.83376202,8762198.37985933
33,4,0,1,5,10,2116176.40585614,7319215.21235937
28,1,1,0,2,4,1751064.39253528,5276103.39910655
32,3,3,2,4,12,2122214.60475283,5481683.95826157
20,4,0,0,7,11,1933006.97442447,6165521.30052193
30,5,3,0,6,14,1646615.72171747,4979989.77965992
28,3,1,1,4,9,1903482.77736955,4435737.59470924
28,0,0,2,5,7,1807906.13659763,6026754.39758608
32,5,1,0,5,11,2426086.78041445,5209043.36838989
10,0,1,2,1,4,1340406.92998794,5331318.81472041
40,0,3,0,7,10,2147264.52576987,6099468.02194558
24,0,2,1,4,7,1739221.31559505,3090932.96849578
30,0,3,1,0,4,1116983.47097301,4211907.25033408
12,6,0,0,1,7,1466847.13784319,4718045.54822089
30,6,2,1,6,15,2614495.68022489,5050843.62649
23,5,2,2,1,10,2387035.28642557,8795181.67457594
15,1,3,2,0,6,1745846.98743975,3645591.84483347
11,3,0,0,0,3,1295292.59870093,4276615.51923116
20,1,3,1,0,5,1420142.20131902,4503553.567357901
27,0,1,2,2,5,1111826.65352835,5532804.07646121
32,4,3,2,5,14,2281596.07644165,2161389.86537066
19,2,1,2,1,6,1815494.43968616,4842989.32767575
34,3,3,0,4,10,2174365.48962251,1379586.10894566
20,1,3,2,6,12,2454973.13282355,5934465.53820653
32,0,0,0,2,2,968950.5418690479,3402513.81382213
27,5,2,1,1,9,1753766.20945303,5811409.53219194
14,2,1,2,2,7,1812065.82347584,4709663.38097189
28,2,1,1,4,8,2095163.88772505,5288544.19027005
23,3,3,2,6,14,1425178.12435321,10070134.7916039
31,6,3,1,0,10,1827461.93390396,5738219.65736541
21,0,2,1,6,9,2181262.44358409,7333609.675519
32,3,0,0,6,9,1914832.7896353002,6650535.57640498
15,6,1,2,5,14,2639554.05927277,5893328.0482748
32,6,3,1,5,15,2227750.80145666,4833434.51731976
21,3,1,2,6,12,2491446.41161832,5999245.63581594
34,0,1,1,5,7,1267570.01763771,3805745.59797139
18,6,1,0,5,12,1776133.37109736,4686293.32961386
26,6,2,2,5,15,1712671.35826367,6472597.80068877
30,0,0,1,6,7,1586684.2464585,5498743.80746838
16,0,2,2,1,5,1869749.99737546,6404620.99376483
29,1,3,2,6,12,2684342.55362374,5950867.64642366
19,5,3,0,4,12,2019571.95162686,7318295.55402596
38,1,3,2,2,8,1732965.48206296,6632944.43231636
32,5,3,1,3,12,2278401.18931338,6182594.49156543
36,0,3,0,5,8,1726872.81181037,3829791.71244138
37,3,1,1,1,6,1438425.5568831002,5958476.30447314
40,5,3,2,6,16,3269941.61730368,7498662.79953342
32,4,1,0,2,7,1643330.13128085,8471391.4535134
21,1,3,0,7,11,2082692.59302987,7781903.48209438
31,5,3,2,5,15,2735230.10941082,7233669.00553553
24,4,0,2,3,9,2228837.15891454,5993409.09426029
28,4,3,2,5,14,2510055.15681416,10005753.309411
20,4,1,2,4,11,2455726.85794293,7057937.5690349
20,1,2,2,7,12,2358367.3010264,9739747.52328843
17,2,1,1,6,10,2103343.09319704,3323318.59079667
40,5,1,2,4,12,1864961.10439304,7302314.71398524
40,5,1,0,7,13,2315026.84608549,7043159.21683711
36,2,3,2,2,9,2180112.49374744,3567982.59959422
38,2,0,2,3,7,1559599.77294545,4134982.29843183
15,4,2,1,3,10,2184843.73320638,3930555.84438477
15,2,0,2,5,9,1829013.95157887,8688356.27754787
11,1,1,1,5,8,1917089.88068223,4286204.11750421
25,3,2,2,0,7,2158216.52157576,6630197.45664282
27,4,0,0,5,9,1772256.99962771,7529958.43731253
33,3,0,1,7,11,2589239.43496181,4964682.52583248
15,1,3,0,7,11,2550126.7813526,6589608.05711138
36,0,0,0,5,5,1688554.00567036,5929456.71401529
36,5,0,1,4,10,1900281.60364018,3606807.72805144
30,3,3,0,4,10,1710233.14752033,4705381.53507226
34,6,1,0,3,10,1616286.26182372,5917522.30888885
36,5,0,0,5,10,2357327.10390433,4425366.00764386
29,1,0,0,6,7,1839271.61425762,4387341.77154175
20,5,2,2,4,13,2438838.66713023,4974405.37860431
10,1,2,0,2,5,1440142.97217013,5738718.49146274
11,1,1,2,5,9,1573832.44422834,6285999.50972926
20,4,2,0,5,11,2587715.14593632,8462688.7367163
36,4,2,2,7,15,2306611.70846006,7000145.84911731
36,6,1,0,0,7,1523871.05491067,4569602.88319214
26,1,0,0,1,2,1204537.1831301001,4082887.79149579
36,3,3,2,6,14,2981014.10597534,7142080.55695686
34,5,0,1,5,11,1601198.20884946,4868837.19450669
17,4,3,1,6,14,2405747.73115827,3800453.0312339994
20,6,0,0,0,6,1503411.56193608,4886007.93321394
29,6,2,0,2,10,1815059.29596172,7068587.220170099
10,1,0,0,5,6,1674541.26148522,6900060.88541477
33,5,3,0,1,9,2063909.06092327,5911243.92459064
14,3,2,0,2,7,2009429.96084391,3632749.22625759
11,4,2,2,3,11,1643296.53967977,5590257.18164202
18,0,0,1,4,5,1643718.16144588,3993742.61208114
32,1,1,2,4,8,1515356.71376014,2494877.39194238
11,0,1,2,1,4,1528347.43877894,3737127.86629188
35,3,3,2,6,14,2562659.47856373,6854553.11709715
21,3,0,0,2,5,1103535.98118811,4917219.79934565
39,4,3,2,5,14,2031739.72158075,7976785.27532932
24,3,2,1,3,9,2047020.59351248,8926249.32705465
36,2,3,2,0,7,1823798.31381911,4846657.94701646
28,2,2,1,4,9,1869428.84001567,4662657.39290079
21,5,3,2,7,17,2412912.19429127,6374254.75564099
25,2,3,0,2,7,1826514.98140932,4364162.30941951
19,5,1,2,2,10,1830565.63708995,7024407.76098256
36,2,2,0,2,6,1604431.44462226,6005335.57824756
19,4,0,2,5,11,2050782.78097702,9924523.50896666
10,0,2,1,7,10,2368181.93278199,7326546.70934695
10,0,2,1,7,10,2256246.46217142,3192197.12899036
38,6,1,1,5,13,2844027.57418027,7129574.10009061
20,2,2,2,4,10,1534357.17742761,6069341.77871115
21,1,3,2,6,12,2522374.7473168997,2698759.7068259
12,6,1,0,1,8,1891729.59298354,5149820.50791813
24,0,0,2,2,4,1379995.74340069,3705844.51441621
25,4,0,0,3,7,1737307.13084538,8469671.8367153
19,2,1,2,4,9,1507775.79503407,7738998.43351757
12,3,2,0,5,10,1564753.20376614,5353822.5349926
24,2,0,1,6,9,1885081.74197434,4937316.10262268
22,4,1,0,3,8,1959661.90323811,7725520.65164863
10,0,3,0,2,5,1734859.84184099,3665849.0973305
27,3,3,2,6,14,1774388.39413538,8179674.00151872
27,0,3,2,3,8,1858383.73604722,7385465.71020113
35,1,3,1,4,9,1715252.79355378,7041234.684774401
36,2,2,0,7,11,1822015.87772554,7617888.72899023
20,1,0,2,0,3,1100033.44905011,1885734.32101568
18,2,2,1,3,8,1905512.8255365002,8138047.51395996
40,3,0,1,2,6,1400846.58603518,5550882.18582511
12,5,0,2,3,10,2288562.7344593,6076508.18815565
13,6,1,0,7,14,1986851.67876338,6927342.22157471
16,1,0,2,7,10,1847550.53796712,9172187.71215272
16,3,0,2,1,6,1892892.34870146,4218381.68330582
15,2,2,0,2,6,1766683.18492913,7839269.60026352
33,2,3,2,2,9,2060811.3983701,5839785.47143602
18,4,0,2,7,13,2800678.67103031,8356722.96926968
28,1,0,1,7,9,1953012.45144409,7623761.67485349
10,6,3,2,7,18,3091074.32800828,8663877.45490623
32,3,1,0,5,9,1361298.55922688,4181567.59879215
23,6,3,2,5,16,2710127.64852089,14264964.460228
31,5,1,1,7,14,2306820.68651083,7801965.8013912
16,1,3,0,1,5,1331727.28931509,2399240.84921474
24,6,1,2,5,14,2383776.08034199,8078361.76901544
23,0,2,2,1,5,1719828.00090886,7124103.58883943
31,5,3,0,2,10,1946741.27558132,6112335.67697596
15,4,1,1,7,13,2405444.83539221,5429679.71064022
36,0,3,2,2,7,2064149.59891058,5394318.63436367
31,2,1,1,5,9,2244454.69736326,6459687.56218718
23,1,2,0,0,3,1238017.23910239,2317791.26176746
32,6,0,2,1,9,2291842.26076574,4640068.8385501
18,3,3,0,5,11,2097140.46644246,7403631.11145478
11,1,1,2,7,11,1678031.89603048,7825869.46639875
22,0,0,0,0,0,1443973.62340783,4229442.49324822
22,4,2,2,3,11,1485356.09661474,2061355.07123812
38,6,0,0,2,8,1878277.18135911,6007171.30313622
27,0,1,0,6,7,1900434.32513501,3430621.93078075
34,0,1,1,6,8,1555442.78869042,8532525.52022878
26,5,0,2,7,14,1770977.84728071,6053625.75857688
34,2,0,2,6,10,2614814.75302356,4171723.43432945
11,3,2,2,4,11,2092154.15131214,7318616.20539231
28,6,3,0,0,9,1623338.18183971,4474357.13967148
31,5,2,1,4,12,2667368.40235524,5285554.11199216
30,4,0,2,7,13,2191353.9765282,7368575.64393698
23,0,2,1,5,8,2310873.38702125,3543164.78367095
14,4,1,2,4,11,1777849.7467148998,6580520.42288851
36,1,0,1,4,6,1746346.64621478,5927942.22699854
18,4,0,2,6,12,1827174.48993868,5690606.62794077
15,6,0,2,7,15,2229149.72826898,9232800.67071429
19,2,2,1,1,6,1156102.91844247,6192417.39277876
15,6,0,1,7,14,1986235.05181145,7822514.22847111
34,0,1,2,1,4,1353951.39143311,3233289.1140726004
16,3,2,0,5,10,1846619.0095724,6416073.46062054
32,0,0,1,3,4,1121151.17095975,4557984.2176369
29,4,2,1,4,11,1942951.67156146,6946431.53448073
19,2,2,2,6,12,2123270.89985199,5280272.26275274
15,5,0,1,1,7,1752699.88794975,5574418.48041125
21,0,1,2,3,6,2055497.80693739,4115840.0379222
34,2,0,2,4,8,2016296.59130735,3085799.71665904
36,5,0,0,0,5,1422436.11819645,7484818.92179681
27,0,1,0,6,7,1129772.15191872,3607172.31890236
16,3,1,2,6,12,1779619.29025952,4145951.76920579
16,3,3,1,1,8,1608051.88713266,4422927.39206337
36,2,2,1,3,8,1732103.95095518,5326900.17359407
28,3,3,0,3,9,1801076.93870063,5271768.22148941
40,2,3,2,1,8,2092465.6927128998,4220523.69190909
24,5,3,0,5,13,3143036.67509128,7834401.705303701
18,2,1,2,7,12,2120031.99795092,8074053.76277972
34,3,0,2,6,11,2195754.88145718,5394601.57368918
37,0,2,0,5,7,1733805.6753349998,2969636.76679548
34,4,1,0,6,11,1535773.43570045,4630668.03128245
21,6,3,2,3,14,2192937.16781816,4339477.49776184
40,6,3,1,2,12,1821711.91222984,6414532.18298849
24,2,0,1,2,5,1490907.74170028,3412609.10095448
39,3,0,2,1,6,1613005.22247843,5844297.20409563
26,2,0,0,3,5,1555815.38568341,5166493.34076991
32,3,0,2,3,8,2268931.40705738,7219012.03924004
10,3,0,1,3,7,1581180.02982381,9067031.98422938
37,6,2,0,0,8,1975235.91873469,5388960.51105542
21,4,1,2,7,14,2158945.2261086996,4916351.71992553
15,5,2,2,4,13,2094405.77138522,9529430.73447679
26,1,3,1,2,7,1758434.60278798,5452838.45068821
15,4,3,2,7,16,2638485.1789632,5791381.44813998
37,5,3,0,1,9,2129891.64505018,3949215.27270513
16,1,1,2,4,8,1469812.45853907,1974376.54769087
32,4,1,1,3,9,2131111.37134393,4594894.42157345
30,4,1,0,4,9,2003182.71377883,5989344.38419669
15,0,2,2,1,5,1654216.02031307,4351235.51833313
29,4,1,0,6,11,2134514.49666966,6090874.80434591
38,6,3,1,3,13,2585362.5462056,6261149.89729371
15,2,0,0,5,7,2059451.90843338,2703751.70322277
19,2,1,1,1,5,1451445.40544794,5535909.34917724
10,1,0,2,2,5,1369256.20331972,6007164.22170108
33,5,0,1,7,13,2047698.62443084,6381902.96397117
27,2,2,2,7,13,2353745.08300116,6231939.21291996
23,2,3,2,0,7,1537536.44326488,3804605.06348043
29,2,1,2,3,8,2004758.36020849,5114558.84303274
18,0,0,2,0,2,1882124.65761731,3874609.70498497
21,5,1,1,3,10,2107180.32701369,4320478.33222788
16,2,3,2,1,8,1541161.51046537,3657004.09912019
13,2,3,2,7,14,2976977.2806055997,6747899.87069334
19,6,0,0,0,6,1776613.38759846,6021324.21519437
11,5,1,0,4,10,1984451.35601381,4243515.61984481
38,4,1,1,1,7,1765592.34441343,6840354.87660642
17,3,3,0,3,9,2143289.05243566,5209571.49887846
37,3,2,0,5,10,1677122.5866146001,8431131.94675161
40,1,1,2,5,9,1759946.07678632,6735660.08519408
27,1,1,2,2,6,1900838.45700655,3095004.28813747
13,5,1,2,2,10,1676325.4358379,1672904.74051978
35,4,0,1,1,6,1422115.36862589,4552567.10682373
16,3,3,2,7,15,1880161.88965351,5753097.8996897
25,5,3,1,7,16,2650228.06008417,8704312.81647654
29,0,1,0,0,1,825288.1684412791,5147660.00032301
19,1,2,1,1,5,1282848.27798971,7864607.17905876
25,4,1,2,6,13,2717929.59209664,5575979.99855768
33,0,3,1,1,5,1333898.39641448,3292237.98557067
22,5,1,0,0,6,1678961.39532494,4344252.86178785
25,2,3,1,3,9,2206507.59811634,5988391.41034818
34,3,0,0,4,7,1958857.98680652,4296538.27041836
38,4,1,1,1,7,1755358.12773554,3963552.30194841
13,1,3,2,4,10,2267692.95967286,7603006.5716382
20,5,3,0,1,9,1384317.06518768,6218711.32333222
40,0,1,0,4,5,1774493.17654994,3264034.03921582
13,5,3,0,6,14,2563242.30021365,6132614.92976037
11,5,1,1,4,11,2004925.11595708,7094998.37329079
19,2,3,1,7,13,2162180.67221713,4617854.40738621
22,0,0,1,7,8,1051887.84997559,3463377.07428068
35,5,0,0,4,9,1924345.78583477,6396174.45397533
33,5,1,2,5,13,2433575.01203438,8138585.98591403
29,5,0,2,0,7,1582858.05394878,9517743.6112724
11,0,3,2,6,11,2618895.9480541,8855564.07031021
22,1,1,1,2,5,1785243.19361373,3811206.25756741
26,6,1,2,6,15,2878804.56237131,9200906.89278794
24,0,0,1,5,6,1480754.4814514,4987424.91350813
12,1,2,2,1,6,1848582.35805835,6254143.08201903
33,4,0,0,4,8,1924624.07993632,3993335.87196812
32,4,3,2,1,10,1545085.6545382,7459941.84333994
35,4,0,0,7,11,2282854.63793722,6195254.62432127
21,5,1,1,2,9,1825618.68575188,4876113.06809904
25,2,2,1,5,10,2147197.62567384,7449609.51043129
14,5,2,2,1,10,1640232.66563943,4705251.58769769
16,6,3,0,3,12,2369843.836034,5786378.66647061
17,2,3,0,0,5,1270614.54418458,3740151.21628696
17,5,2,0,7,14,1760422.4414444,4887145.86260803
25,4,1,0,2,7,1910885.38186333,5854059.15748959
37,1,1,2,2,6,1854311.97554554,4536721.5019138
32,6,1,1,7,15,2604740.38036733,10053511.7707501
35,5,1,1,2,9,1613742.38846405,6135059.72567384
33,5,0,0,3,8,1476712.56876678,6116537.51203739
25,4,1,2,4,11,1650519.24971128,7819364.11299513
33,4,3,2,4,13,3119267.03717059,3563144.63635625
33,6,1,1,6,14,2377911.24969804,8728018.330029
33,4,1,1,2,8,1604098.81981263,4117401.34983837
14,0,0,2,6,8,1462993.11828838,6887085.0791366
23,2,0,2,1,5,1477448.68245665,6671614.4046377
22,2,3,2,4,11,1905735.68749531,3334976.43243077
15,1,3,1,4,9,1236289.00860432,4962236.73366942
36,4,0,1,3,8,2108674.77910407,6800816.54961917
39,1,2,0,1,4,1675811.28796411,5221854.93153438
40,3,3,1,1,8,1832847.14737631,6138656.49553318
12,4,2,1,1,8,1874453.30946603,4998249.04290412
18,4,1,0,3,8,1727624.60037288,6017982.48914751
10,0,3,2,5,10,2269359.82413457,7733048.15713766
36,2,3,2,0,7,1484354.66692599,5683051.65046913
39,0,2,0,0,2,1229655.8943193997,3878498.93451407
32,6,1,0,5,12,1870797.47937621,4656166.519040401
30,0,3,0,5,8,1564233.37036529,5485448.79716154
27,1,3,2,4,10,1825162.84276798,8018688.60568441
28,2,1,0,0,3,1279949.12905666,5808224.02222265
19,4,3,1,4,12,1780844.24746679,8154313.63674242
39,0,2,2,7,11,1952215.2883149,5899347.04977662
32,5,3,2,2,12,2205649.60559775,10022690.161895301
21,5,1,2,7,15,2771644.97911968,8067653.44299533
39,2,1,1,4,8,1514552.38602627,5929174.48929049
40,5,3,0,0,8,1959957.74208529,5919107.06572159
20,6,1,2,1,10,2263267.96185329,3025888.16466918
20,6,3,2,6,17,2502062.72000072,9157260.59907486
27,1,1,1,7,10,1400257.95034348,5124647.85292268
28,5,0,2,0,7,1825351.89706764,8207256.33814064
15,2,3,0,1,6,1887858.91760722,6528172.84098336
14,4,1,0,0,5,976840.507037475,6290808.41916212
28,6,0,2,0,8,1423799.26369327,5754567.39426376
33,1,1,2,4,8,1821934.79842136,2205379.29586397
31,4,3,0,6,13,2234741.6872595,9487464.06702355
24,1,1,1,0,3,1439190.24888212,911173.6282568041
18,0,1,1,4,6,1902406.54139456,4296070.81572366
12,5,0,0,3,8,1748350.20215511,2725379.73499068
19,4,1,0,7,12,2138894.17594267,8355065.17594992
37,5,1,0,7,13,2384371.56941225,8117216.3781183
40,6,1,0,6,13,2298378.7434406,6754296.11275229
38,6,2,2,7,17,2689117.55971933,8990663.0268531
25,5,2,2,2,11,2074222.12087901,4819416.30676859
35,1,1,0,0,2,1584638.56484159,3010932.68477462
22,1,2,2,5,10,2083839.71582452,7968411.56681698
20,3,2,2,7,14,1682220.26443599,7653766.82398274
20,5,2,2,4,13,1755294.56822617,5614367.43840405
31,4,1,2,1,8,1439969.51096476,5713678.62244924
19,1,3,2,2,8,1609491.22152746,1609491.22152746
18,6,0,1,4,11,2425848.66984258,2425848.66984258
25,5,3,0,6,14,2556217.13634897,10618697.3546365
20,2,1,0,2,5,1259779.87030777,1978964.05480867
21,4,0,1,6,11,1782018.09238079,3218017.85432946
25,1,1,1,1,4,1743620.6981846,4023781.64076795
22,6,1,0,7,14,2141978.80778825,8321177.71995387
36,1,0,2,4,7,1289006.38746599,9186554.018719
23,2,3,0,2,7,2118279.89334362,5353876.02468435
34,3,3,0,6,12,3049403.57786394,9647135.13929908
19,4,3,1,6,14,2665380.67430116,6519681.21875304
33,3,3,2,5,13,1970714.16467327,8702542.25864021
29,4,2,0,7,13,2232637.47268259,6011020.93427069
30,2,1,0,5,8,1121575.43540459,10471852.3510611
25,5,3,1,4,13,2349746.97990233,7592212.11369072
40,2,1,0,3,6,1036053.73432689,5055771.53816178
38,3,3,2,3,11,1837466.43098838,3916846.49476053
39,3,2,2,6,13,2073791.42123235,7727147.38102286
15,3,1,2,7,13,2229931.55343868,4102955.4614628
18,0,3,2,5,10,1838482.12631889,6303001.55923487
23,6,3,0,4,13,2779439.64738507,9544887.30011174
14,6,2,2,6,16,3052847.87145204,6117268.88477235
17,1,2,2,2,7,2006027.82550616,6821948.09667177
24,5,1,2,1,9,2102511.90998249,4312329.66465341
13,6,0,1,1,8,1729311.1676448998,6016889.537763201
12,1,3,2,1,7,1487107.73811362,5977749.74423002
15,6,2,1,5,14,2528130.97107855,8664375.75314692
37,0,2,2,0,4,1310699.52771155,3328661.41273605
11,0,0,0,7,7,1284879.17903254,4617549.85446866
21,0,1,0,5,6,1768061.88429048,6109092.72519249
35,1,1,0,0,2,1402627.34454311,6797084.84046412
17,0,0,1,6,7,2113416.56193271,5665881.81916776
11,2,0,2,2,6,1414052.51822972,2206857.19038341
40,1,0,2,7,10,2060145.77176182,8330716.13020672
10,5,3,1,5,14,2477505.2034809,8660299.10587298
28,4,0,2,4,10,1863312.86762162,5919970.02994797
14,5,3,1,0,9,1257942.68868767,5565200.90897754
34,1,2,2,6,11,2139836.73100861,7166003.50988751
20,0,3,1,3,7,1404685.73802317,7108785.70194441
22,2,2,2,7,13,1983626.83708483,6898153.49233331
35,3,3,2,0,8,2427906.10498863,5216540.7110039005
20,5,1,2,2,10,1271515.37028695,6587447.24091398
10,2,1,0,1,4,1401242.09620937,1625564.14442534
15,4,2,1,1,8,1889974.60687673,6242835.388297
33,0,0,0,0,0,908132.9911778009,2840399.51984477
10,3,1,1,1,6,1772633.96068409,4955478.74525283
18,4,2,2,4,12,2648893.47345469,7054272.18916367
34,4,1,0,1,6,1849936.58274326,4721755.07159088
28,2,2,2,1,7,2129792.21706778,7195375.65286476
18,4,2,0,3,9,2301473.56847154,6428078.77395545
12,5,1,1,1,8,1836294.23459017,2634770.76221808
10,5,0,2,3,10,1510504.31219179,5526000.44055982
30,2,2,0,1,5,1712924.77240826,4915714.03511902
20,0,3,2,0,5,1585818.80090883,3882264.43129929
22,2,0,2,5,9,1808015.96545944,4360361.12746169
25,5,1,2,3,11,1953768.54301125,4849841.33365216
34,1,1,2,7,11,2133116.33172806,8542417.05938565
33,2,0,0,6,8,1880080.61725529,6108218.76507041
16,6,3,2,0,11,2209662.1727297,5370425.50894805
28,4,3,1,1,9,1899345.9141573997,4524813.97027071
20,1,3,2,5,11,2312926.55952342,5486158.28970152
37,0,3,1,0,4,1416004.49919222,1314808.91567302
22,5,1,1,2,9,1773138.92168447,4481081.80277748
20,1,0,2,5,8,1800014.35321668,5339344.57430714
24,3,0,0,5,8,2203124.5212064,6862353.79926367
34,1,0,0,6,7,1288798.56330927,7592948.01639119
16,4,3,1,5,13,2103823.67600501,5885797.77699038
32,1,1,2,4,8,1429734.47283828,2694872.41665272
33,5,3,2,7,17,1946374.48129692,10936687.1715478
13,5,1,2,7,15,2283788.12549307,10732313.4286578
11,6,1,2,5,14,2833623.32075738,7631788.31834794
29,4,0,0,0,4,1241211.61855777,5581567.45012616
30,6,3,2,3,14,2265811.63771204,7073887.69768853
33,6,1,0,3,10,2077614.52094414,6561022.10133587
10,6,1,2,1,10,1986236.71462888,9385252.34178382
25,4,2,0,7,13,2020707.71053199,2124017.69060334
36,3,0,2,3,8,1913913.20228717,5693981.78925549
28,1,2,2,0,5,1956033.51640447,4294621.86343228
23,4,2,2,6,14,2281241.27369042,8126940.57810766
40,6,1,0,2,9,2001775.14167187,6618452.88060927
28,5,3,1,0,9,2295715.80598533,7224937.13024534
30,0,0,2,6,8,1862066.35639392,5514434.79091534
30,2,2,1,3,8,1987058.16410638,3489483.4578870004
19,4,1,0,2,7,1856829.95609874,5092611.72819802
39,3,3,2,4,12,1758143.52071789,6236092.30254618
40,2,2,1,6,11,1982430.0570927,6257952.04062113
30,3,0,1,5,9,1582400.15277378,3892996.75641859
15,4,2,0,6,12,1935641.25736288,7612833.20249717
39,6,0,1,6,13,2027943.81414785,3287203.70971484
37,0,3,2,4,9,1810250.11082879,3082639.63731581
22,6,0,2,6,14,2118248.25559923,5970988.0404134
13,0,1,1,5,7,1455680.94494587,3979534.09244272
32,3,0,2,3,8,1738590.5961308,5572528.16043153
17,3,0,1,2,6,1268131.11815562,2980733.6490219
19,1,0,1,6,8,2073852.48198928,4588307.1788679
36,5,2,1,1,9,1269704.24714168,6108659.86602977
24,2,1,0,0,3,1218748.8943952,5456222.55578726
30,2,3,0,6,11,2128138.80761481,4747611.32503118
15,4,3,0,1,8,1757120.43128662,5456271.95594073
37,4,2,1,4,11,1931524.6893698997,5460953.0947585
36,6,2,2,3,13,1642720.16945101,5824059.27312076
13,1,0,2,0,3,1487745.78978866,3748608.85367833
16,0,1,0,1,2,1302064.91969674,2748866.91183764
10,0,3,2,1,6,1240006.57272832,4058277.6953687994
31,3,1,1,0,5,1586894.56350763,1523638.11011988
18,2,3,1,6,12,2181679.64073676,7873526.88162309
20,1,0,0,6,7,1702859.4926525,5871052.72480843
29,0,0,2,4,6,1569166.95151384,3613968.02183425
10,3,3,2,0,8,1997128.3726368,5402888.62700626
36,0,0,0,1,1,1155591.33240385,4626670.7583229
40,4,1,2,4,11,2374567.79562069,4707741.82399024
10,4,1,1,6,12,1434131.00937636,6374667.52824269
26,6,0,0,5,11,2265938.49233288,7430916.72965341
34,0,0,2,6,8,1760830.08135728,6915501.12323768
27,4,2,2,1,9,2010518.87622651,6612123.37513137
12,5,1,0,6,12,2422944.80232633,11324926.963494802
11,6,0,0,4,10,1978173.79458083,4373136.15482937
32,4,3,1,2,10,2179884.10439374,2043811.21992651
29,0,0,1,4,5,1418449.24664986,5607968.37784983
13,4,3,1,1,9,2065718.1196672001,2330637.90631729
15,5,1,0,4,10,2210455.65029617,4587335.54574924
16,5,3,0,3,11,2265662.62204281,7041014.81747896
40,4,2,2,5,13,2836276.23382831,5120294.84951669
13,0,3,2,6,11,2239410.23853036,4847372.66436556
22,6,2,1,5,14,2014381.24355407,5885232.18564707
13,2,2,0,6,10,1977076.03303117,4583845.75106187
18,1,0,1,6,8,1648658.11379358,4491588.92587408
18,3,3,2,1,9,1970005.51443689,2666069.26844996
29,5,2,0,3,10,2131665.48824333,5721428.46515641
23,0,1,0,2,3,1299871.54120447,5611734.86114197
36,1,0,2,6,9,1912491.44267744,6742533.38630217
27,3,2,1,7,13,2683049.97032441,10997660.6355258
25,2,2,2,6,12,2199021.01307242,7121975.75643665
27,0,0,1,5,6,2144995.41799831,4792701.30872503
10,5,3,0,4,12,2072210.84678474,8541783.67314253
32,1,3,1,7,12,1946400.04466779,6891200.090728099
31,2,1,1,2,6,1818173.71500724,3590878.569971
21,5,3,2,6,16,2237954.87939731,5701097.73237454
33,0,0,1,6,7,1432348.85285115,5396726.73039252
25,1,1,2,0,4,1228984.45384981,4277573.60182008
19,1,1,0,2,4,1018079.38596309,2399658.06801931
38,5,2,2,6,15,2781981.3922082996,8544126.07292311
14,4,2,2,4,12,2413695.81675371,5763335.18725275
22,0,3,1,6,10,1659025.33137146,6812660.28936751
11,6,1,1,5,13,2385378.04131747,6998314.65652136
33,4,3,0,2,9,2383483.96892757,5911381.36978839
21,3,3,1,3,10,2432622.82132652,4914257.63185596
36,5,1,2,6,14,2285374.99985362,12543675.2797679
33,2,1,2,4,9,1885384.75811684,4582075.47939319
16,6,3,1,1,11,1738611.5620745,6426667.05746493
26,4,0,2,2,8,1360193.15664116,5003470.66988157
30,6,3,2,7,18,2247063.31771997,10668164.426291
32,3,2,0,3,8,1719683.8744599998,6402253.55258655
38,3,3,2,1,9,1827140.66632565,4794918.96634105
12,4,0,0,2,6,1762812.57520224,6999981.41593548
25,1,2,0,1,4,1267036.30525168,4490266.2878579
20,1,0,1,4,6,1698287.98444449,6425376.96215161
20,3,0,1,5,9,2766034.55333793,3596291.50739041
35,2,1,2,6,11,1606084.27418512,7022569.33046478
14,6,3,0,1,10,2270183.06074385,7184910.29314994
22,6,0,0,0,6,1929092.36969792,5305752.52191583
39,2,0,0,6,8,1606541.85688258,4591259.30138971
12,5,1,2,7,15,2577473.06291674,4611775.7792304
40,5,0,1,5,11,2326600.31907244,6132293.57563364
33,1,0,0,1,2,1259307.43440434,2875978.20112216
22,5,1,0,4,10,2307812.32633968,2405433.32277753
15,6,0,2,3,11,1582049.90757665,8387689.89104855
24,1,0,1,0,2,1112415.32014509,805671.3029265121
37,3,2,1,4,10,1852984.54009474,4891266.47162082
22,5,3,2,4,14,1841168.4059901,7664232.01206161
27,5,3,1,7,16,3411378.5196308,10187656.6782609
13,6,2,0,1,9,1668012.62424699,8113865.047137401
14,4,1,2,3,10,1892597.930576,6445649.90653811
36,5,2,2,1,10,2125162.70408005,4875098.32197947
34,4,2,1,7,14,2156535.74405584,3775852.31844036
27,1,0,0,7,8,1858098.57465442,6141462.86315469
36,0,2,0,3,5,1543964.14413616,1543964.14413616
12,0,0,1,1,2,1242641.24803088,3416741.54164863
32,5,1,0,7,13,2765666.8103831,10389234.832333501
16,6,3,1,5,15,1825253.74214239,7827303.76144639
27,3,0,0,2,5,1181847.27417634,6857096.08508754
21,4,3,2,3,12,2386707.53357694,6945634.40625603
27,4,3,2,4,13,1776797.68118696,3934067.43661475
31,5,2,0,3,10,1819148.81832022,5932633.91388454
30,0,1,1,3,5,1575143.94389173,269092.832914031
32,6,1,0,7,14,1958385.89760349,6565149.04140047
15,2,1,1,1,5,1393887.01925245,4607749.84271875
11,5,3,0,6,14,1961691.8959305,10382354.661546199
27,3,2,0,1,6,1465016.03595219,1990344.4419224
14,6,1,0,5,12,2381312.18018311,9535773.03016106
15,6,2,0,0,8,1593719.36384136,5330828.22244418
17,5,2,0,2,9,1761194.17357723,3948615.51144621
22,5,1,1,6,13,2092372.40737902,9587078.78451653
20,0,3,2,2,7,1742778.51548217,5138045.33569593
13,1,3,0,6,10,1961982.84782388,5959112.06578213
13,3,0,2,1,6,1725800.78449664,4661518.64579054
23,1,2,2,6,11,2114619.44187466,7977345.66547955
15,4,0,2,6,12,2636751.96412574,5255426.19701009
17,5,1,2,5,13,1968605.55951435,7385193.38172874
28,3,2,0,0,5,1796994.25430022,5089787.38773996
35,5,0,0,6,11,1869108.74814002,7695906.50893916
33,0,2,2,2,6,1486411.67091803,5081446.39671625
15,2,2,2,5,11,2019719.43080029,6200806.75457545
11,3,2,2,4,11,2413223.43726528,4538079.58569263
20,4,3,2,0,9,1841148.67662321,3812183.22733394
32,6,0,1,4,11,1558602.78282641,8043781.808923401
10,3,1,1,3,8,2182318.03750047,3671210.96505213
13,5,0,2,7,14,1929601.93245059,5190523.42666963
38,5,2,1,7,15,2762723.08790019,6828356.227486
38,2,2,2,0,6,1554521.77217361,1554521.77217361
11,0,3,1,4,8,1767611.33657904,4331272.51606608
26,5,0,2,5,12,1331445.61038667,7496588.4629707
31,0,3,1,0,4,1340996.51021989,4734951.74155725
23,5,1,1,4,11,2258968.79365951,4814520.98703234
17,5,2,1,0,8,1712407.58396632,2370005.96985939
13,2,2,2,5,11,1864107.21091602,4538737.63817167
12,3,3,0,7,13,2466636.81923669,8915145.36085655
18,5,3,1,7,16,3009532.25281203,11101773.984445699
31,4,1,2,2,9,1770053.52093554,7430420.31015142
29,0,0,1,0,1,904526.111052135,1360164.05144051
40,0,0,1,3,4,1693203.38559838,6451340.81168272
30,5,1,0,4,10,1869347.48316849,5493160.70302677
34,3,2,1,0,6,1991033.21233506,4080117.52259266
13,5,0,1,3,9,1238348.86606512,4355723.68000907
23,2,2,1,7,12,2409298.8819648996,7397989.85693589
18,5,1,1,7,14,2682959.06855172,11587662.529710699
36,0,2,0,0,2,1227307.0455068,946329.4328133271
39,3,2,0,4,9,2130645.1052216,6893101.78996504
32,3,3,1,3,10,1674751.20862942,2856380.42815784
30,6,1,1,2,10,1486927.2558068,5712639.69781102
12,3,0,2,2,7,1156577.40104951,6451536.35112021
15,3,0,0,0,3,1014392.39491193,3821400.28569923
21,3,3,1,5,12,2110505.38036972,3560184.1949209
21,0,2,2,3,7,1795980.59661458,4924381.37886999
11,4,1,2,3,10,1610369.77539045,3523271.9749745005
34,0,1,0,5,6,1496618.49538522,3393675.22024416
27,2,0,0,0,2,1249547.17832551,5098817.07801131
31,2,0,0,5,7,1789893.76612231,7611568.39327354
25,3,0,1,3,7,1631942.62092038,4933413.14243502
36,6,0,2,2,10,2068051.45087162,7107284.88306856
20,1,3,2,3,9,1504485.19995872,6636495.63032972
38,6,0,1,2,9,1946380.06596618,3634864.89310076
33,5,0,1,7,13,2698390.04878557,4297945.16193131
25,0,1,0,7,8,1169517.35065546,4544940.23849467
18,1,3,2,0,6,1504669.7016353998,2840928.15247271
35,3,0,0,3,6,1565308.83225753,5097566.76514168
31,2,1,2,4,9,1619499.21650725,3124624.33562443
25,3,3,2,1,9,1478311.06459024,4532885.89871191
30,1,3,0,1,5,1457729.64194628,3540767.00847534
23,4,1,0,1,6,1399829.07051691,4879874.46319168
18,3,2,0,0,5,1403525.73735546,5117944.17907776
15,3,0,1,1,5,1429100.95674685,3370640.46159295
34,2,0,0,3,5,1106870.78428038,7174980.09665182
38,6,0,0,2,8,1871364.89795852,6995159.07828882
26,1,1,0,3,5,1108501.97333247,5887468.83121274
12,6,2,0,3,11,2134407.78041867,4760417.63515527
36,5,3,0,0,8,1554244.25957253,8918691.69765345
23,0,0,2,4,6,1682399.1995838,4654168.1954957
23,6,0,0,2,8,1907598.39850103,5187726.37592723
13,0,0,2,7,9,1650880.78102682,6693847.70086371
29,4,0,1,1,6,1544137.9685363998,3658356.44108937
23,2,2,1,7,12,1865201.61278481,9198153.23447545
27,4,3,1,2,10,1983375.26721376,3992286.49068623
37,2,1,0,2,5,1543737.66811874,2425243.84948511
39,3,0,2,6,11,2310954.46323626,6925456.80636765
33,6,1,2,1,10,1924800.45982565,8013268.12628017
10,0,0,0,6,6,1581318.91051479,5234994.06653811
17,6,2,1,1,10,1690385.0369873,7046147.42236395
22,3,0,0,1,4,1184004.82596679,4943005.7997797
24,0,3,0,0,3,949725.689449402,4313021.41665645
34,6,2,0,6,14,2356765.14658756,7442124.36688431
25,3,2,1,6,12,2522460.02281186,6145335.772847599
10,2,2,2,2,8,1350717.41687604,6518217.46790952
16,3,2,0,3,8,1995507.67901707,5099219.549731201
17,1,0,1,5,7,1356485.30445164,4985182.1928018
28,4,1,1,2,8,2009479.57914206,4385944.97754255
23,6,3,2,7,18,3408180.47026088,7963405.97878249
20,0,1,0,2,3,1666603.26558788,2933871.3127168
25,5,2,1,0,8,1741243.8713616,4620567.10915757
13,0,1,2,4,7,1740946.0628963,5125119.79749186
20,0,1,2,0,3,1299008.58838737,6717837.64937973
21,1,2,0,3,6,1887790.50359488,4824518.06077107
34,2,3,1,5,11,1678994.51665959,4156957.49406428
24,1,0,1,6,8,1864506.7677904998,1285415.85879658
24,0,3,2,7,12,2178417.15003027,4787804.78203484
14,0,2,1,3,6,1667382.51537297,6128364.21709798
14,6,3,2,3,14,2624742.20002421,4671883.54341903
13,3,3,2,4,12,2114054.71219129,5425228.03372297
18,5,2,1,7,15,3246855.96935679,7182672.24912227
24,0,0,2,2,4,1564300.13222856,5266837.93457984
22,4,0,1,5,10,2035490.80427609,8754888.83088898
11,2,1,0,0,3,1406702.85611826,3599536.45993497
28,1,2,0,6,9,1658326.07338698,4934465.10946137
24,2,1,2,0,5,1133985.99974098,5886597.8245967
39,5,2,2,6,15,3312066.18028207,7459663.13119778
39,5,0,2,3,10,2068334.23976574,4806307.81710555
26,0,2,1,4,7,1364236.65740345,2879524.96147364
32,0,1,1,5,7,1202769.05809953,4183204.58847489
16,1,2,1,1,5,1195604.9624539,5756073.25815408
12,1,3,2,5,11,1922963.37417703,6789027.52887965
19,4,1,0,3,8,1871640.34294898,7071353.58389742
28,2,2,0,0,4,1413358.49678704,5205049.29327672
21,2,0,2,7,11,1902525.64995626,7502894.66164745
26,3,0,0,3,6,1665774.18701396,7822664.41713531
14,6,3,0,3,12,2215073.36144636,5556901.43223179
38,0,3,2,6,11,1586343.97293098,5240525.60246145
23,4,3,2,5,14,2320999.83377677,6299547.59930287
24,0,2,0,1,3,899187.663437906,4078304.99862018
31,6,1,2,4,13,1995331.06069092,6386705.97270736
14,5,0,1,4,10,1960641.42640022,5734840.13614672
16,3,1,2,1,7,1571590.41063861,3572915.87253036
11,2,2,2,3,9,1923252.49928602,9367830.93491989
19,5,2,2,7,16,3231084.94437088,9141349.81928666
24,4,1,2,3,10,2135751.03737057,3116185.31536068
37,4,3,2,0,9,1929566.99519037,6489496.39941432
30,0,1,0,7,8,1445508.05535491,5963056.86635868
28,5,0,2,5,12,2580468.75709623,6743896.56174457
12,6,3,0,3,12,1849401.08111954,5225655.65198178
37,4,1,0,6,11,2187608.71225197,7789235.03610888
33,0,1,2,3,6,1748515.08818111,4395389.92599346
22,3,2,2,3,10,2177754.21147178,7090691.38810356
34,1,1,2,0,4,1422207.75109692,4160884.23046434
25,5,1,1,3,10,1884561.75313229,7100222.65268684
29,1,2,1,1,5,1152138.46334697,1459103.64363826
16,1,1,1,1,4,1630832.39313388,2629045.91341972
40,6,2,1,7,16,2204143.6924672,9030972.97658479
25,2,3,2,0,7,1622637.87510971,4700919.58248301
17,4,2,0,4,10,1551989.78991706,8234996.08181972
29,5,2,1,0,8,1720399.26079955,6392471.44237025
24,6,1,0,6,13,2381789.79395729,8679880.70568818
23,5,0,2,3,10,2174021.96862316,3068834.7730725
40,5,0,1,6,12,1891726.45169455,8122875.49227848
23,6,2,1,6,15,1723296.23328163,3474611.54844209
32,1,3,1,3,8,1889138.2607711002,4414342.51939439
16,2,2,1,1,6,1532737.09284474,5516448.37868793
17,3,3,0,6,12,2314408.9282477996,6497862.49082855
31,4,2,2,7,15,3016931.1457609,7895194.38989883
12,2,2,2,5,11,1627659.78027365,6872959.16530933
25,0,1,1,5,7,1872627.96356909,5491279.1978359
23,6,1,2,0,9,1857112.05211075,7522434.190229901
23,5,3,1,5,14,2202110.54146399,8483474.43587143
24,5,0,2,6,13,1878148.29943122,4884643.13890431
27,3,1,1,0,5,1458425.59135013,5675400.76923836
26,0,0,1,2,3,1241153.26186866,3795183.62037543
30,5,1,2,6,14,2143755.01714119,7892152.0450569
17,0,0,1,3,4,1798731.32599178,3809122.68984215
20,3,0,1,1,5,855639.142410063,6847758.55788891
29,4,2,1,2,9,1707986.88035309,5270701.27043747
34,1,0,2,4,7,1511671.06583214,6500780.92873864
29,1,3,0,2,6,1392185.44837881,7485979.37891108
17,5,3,2,7,17,3688410.98329768,6620034.22127482
24,0,3,0,2,5,1536047.43745716,6277969.90458136
13,2,1,1,4,8,1472898.65012491,4548102.96925035
17,6,2,1,7,16,2283492.03610518,5544970.12599493
25,5,1,1,2,9,1681947.40552185,5422935.3682473
17,2,0,2,2,6,1628429.83775776,7006338.97622249
40,1,1,0,1,3,1379662.12253987,49240.539287951106
40,3,2,0,2,7,1721399.31009496,6257894.61591909
39,0,3,0,6,9,2188519.54880305,7353870.10514519
33,2,0,1,1,4,1309099.953976,3517653.04892819
39,2,0,1,7,10,1924638.03214513,4733162.02856214
13,5,3,2,1,11,2213672.69921022,5771320.54272845
25,1,0,0,5,6,1671903.88116155,4772147.12845515
13,1,1,0,5,7,1820037.54550093,6826860.11033134
38,5,3,1,1,10,2072293.97506654,3198115.4596646
17,1,0,0,5,6,1701086.58127079,6406451.468436
36,5,1,1,2,9,1859158.6400384,6132411.88708349
39,2,0,1,5,8,1768724.3864708,3962653.62626498
37,1,1,0,2,4,1341782.04163417,2953227.55835916
35,5,3,2,6,16,1906746.28455344,6915613.28468554
38,1,1,1,3,6,1648903.08849147,2719953.71188684
34,3,0,0,5,8,1631189.14870338,5791565.73057754
40,1,3,0,3,7,1703557.43702993,4422322.8818872
16,6,2,0,1,9,1666401.81277308,4844322.1220439
27,5,0,2,3,10,1788255.17479448,4112250.46013222
25,3,1,1,2,7,1876699.02413679,5767942.25745213
28,6,1,2,3,12,2431582.60011446,6825911.09341957
39,6,0,2,3,11,2215752.04312501,4169887.09006961
38,0,2,0,1,3,1643346.47284378,5385986.94687792
12,5,3,0,7,15,2480514.83897642,10929055.237143598
29,4,2,2,7,15,2276650.13862167,5156232.72737964
10,5,1,0,2,8,1872065.36941465,7480891.30177192
30,3,2,0,0,5,1390400.57756893,4174528.14254194
13,0,1,1,2,4,1184001.05203713,1968185.91240133
19,3,3,0,5,11,2482426.97926014,7394932.16732492
23,6,2,0,5,13,2117353.2832049,7654826.04779438
10,3,3,1,7,14,2006025.76161401,8622960.47819544
16,1,3,0,0,4,1199353.22221348,5403155.67156005
33,5,3,1,6,15,1388860.00887792,7156371.1830009995
29,4,1,2,5,12,2308178.74472066,8444299.68232885
19,5,3,1,6,15,2347552.67444284,9914871.86501347
15,6,1,1,5,13,1813011.49383604,7145616.73046575
19,1,3,1,4,9,1932981.73646413,7999607.00510384
33,4,2,2,7,15,3228962.53888207,5875584.97351202
31,3,1,0,1,5,1443820.16396033,4739963.93095035
32,4,2,2,2,10,2426473.05009777,4559003.9283038
17,3,2,0,0,5,1829373.64264811,6852019.65695625
13,6,2,1,6,15,3023117.33107761,10567648.2212407
31,3,1,1,6,11,1901842.17480173,8790437.59918973
40,6,3,1,2,12,2214496.11179924,544251.769642603
25,6,2,0,2,10,2054455.85621372,6910648.749654901
16,2,1,2,3,8,1832270.53111733,4189398.26118835
18,4,2,1,5,12,1276253.45341345,6595205.91747968
28,0,2,0,4,6,1519213.28512069,2290141.48688305
39,6,2,1,0,9,2351516.74981522,4815291.02554675
12,1,3,1,6,11,1957040.80624513,5903011.10649119
37,3,2,0,1,6,1699838.85476279,4263350.59653999
14,2,2,2,1,7,1929774.37170025,4093070.82853216
25,0,0,1,6,7,1752553.26620908,5853948.90102591
31,0,3,1,4,8,1056321.93169124,5983283.61752114
38,1,0,1,7,9,2139657.28650929,5671052.9189205
11,1,3,2,1,7,1666892.96515632,3441863.36452978
38,1,3,1,6,11,1708919.60584145,10627283.668417
27,6,3,0,3,12,2786624.70094843,8904900.24010081
27,4,1,2,5,12,2493557.70178978,3680333.00768374
25,0,3,2,0,5,1823395.86766612,5116129.69381719
17,3,3,0,0,6,1521038.17541545,2019251.73104581
30,1,0,2,5,8,1951442.28580057,6767029.03074043
10,5,0,2,3,10,1870064.21869783,4468012.73668307
31,3,3,0,4,10,2406384.83304098,8686678.71750096
15,3,2,1,2,8,1506469.68622957,6176693.41166749
25,5,1,1,7,14,2684197.79466044,5751515.74340809
36,5,0,0,0,5,1124642.18939274,6176433.52465222
17,5,3,2,5,15,2365208.27507667,3263967.39108701
17,2,0,2,1,5,1496598.45632328,4528747.17104033
19,3,3,2,2,10,1747020.92052078,7585065.10039739
37,6,1,1,4,12,2284387.92835192,6429172.57267644
25,1,2,0,4,7,1378206.88204108,6953851.70534005
14,3,1,1,6,11,1880219.37863621,7060016.61447262
25,0,2,2,2,6,1695948.28792284,4627858.45745352
35,2,0,2,3,7,1206789.91634703,8191849.08694935
35,6,2,1,5,14,2988999.20826148,6336873.98657089
31,6,1,0,2,9,1649098.95966774,5760085.35852263
36,3,2,1,3,9,1267940.93111535,5724807.75293008
26,2,2,2,3,9,1424548.35447513,5107088.93608537
24,2,1,1,5,9,1731113.79839832,4974157.55638835
36,4,2,1,3,10,2491187.68785795,6812130.98449086
19,5,3,1,2,11,2023854.2655031001,7711407.36851112
15,1,2,0,2,5,860084.624855918,4420513.73791152
22,2,0,0,5,7,1615275.09566831,3151032.33511521
26,2,0,2,5,9,1813006.463182,4219440.88400176
20,1,2,0,0,3,1553852.87209872,3913402.85249145
25,2,0,0,6,8,1750737.70013945,4234945.6222875
25,0,0,2,6,8,1801478.58876356,5991131.31285357
30,5,0,1,0,6,1477576.0623466002,4775998.74254868
30,2,2,1,2,7,1838725.77061466,4276416.84763901
15,6,2,1,5,14,2536911.19600494,9595608.09099976
29,4,2,2,6,14,2527223.08932935,7923950.86784024
21,2,2,1,1,6,1521216.62041847,2619773.79519505
31,2,2,2,6,12,2040312.97846323,2499067.71844331
28,3,2,1,5,11,2051403.24326221,8805439.24877279
30,0,0,1,4,5,1352609.42107006,4240379.68499039
35,2,3,2,2,9,1882039.67594399,4017526.31873893
13,2,3,0,2,7,2140992.93021305,2940297.42760386
30,5,0,1,2,8,1976910.47083604,3564877.96349854
37,4,1,1,7,13,2183767.62632733,8808262.44070515
14,0,1,2,1,4,1570956.22370014,2469996.53351769
36,2,2,0,1,5,1515533.9453518,6619105.49378339
27,0,2,1,3,6,1365387.93519714,5947949.6845945995
30,5,3,0,7,15,2032092.19284844,6283077.65463213
19,4,0,0,7,11,1754996.08111392,6992269.41986517
33,0,2,0,4,6,1527649.01409861,6944804.99415503
32,4,1,2,3,10,1707050.96478535,6857296.71451846
16,1,1,2,2,6,1539052.29691975,3941109.52931574
29,5,2,2,1,10,2214270.21987355,8878460.05516744
14,3,1,2,6,12,2310758.23485167,6905959.65771744
21,4,2,0,3,9,1825281.36667273,4467090.36722129
39,2,1,0,1,4,1234988.69987198,3651617.95517357
40,5,2,2,2,11,2298118.62737331,8768667.27451593
40,6,1,1,3,11,2370077.38725432,5029694.02952206
28,1,2,2,2,7,1515120.76470401,4977224.02039555
33,1,1,2,5,9,1680058.42907207,7076264.87432432
38,0,3,1,0,4,1080858.24219192,1295197.05491819
21,2,1,2,2,7,1977715.48997446,4783756.34796953
31,6,1,2,3,12,1844173.22901155,11687023.089644
30,3,2,1,1,7,1738305.2552541,1610012.36636141
37,3,2,1,3,9,1715808.01959581,6642726.79803013
40,6,2,0,4,12,1851095.49608102,4174103.70813995
17,3,2,1,2,8,2086806.55423929,3937011.29446674
39,2,1,1,3,7,1569620.70632249,5083194.15976049
20,2,0,2,6,10,1959093.15719255,3006229.76098779
20,6,3,1,7,17,2230757.78188716,5009457.24540326
13,1,0,0,5,6,1808636.80554296,4712824.56689157
23,4,1,0,6,11,2199950.82091382,5578550.28468257
39,2,3,0,7,12,2606503.42672969,5372506.19318411
10,1,0,0,2,3,1028296.73087318,1319092.83023517
10,0,2,1,2,5,1525524.58144338,4679781.98244691
12,4,0,0,1,5,1629265.59358862,5309698.14350566
33,1,2,2,5,10,1444104.52364018,6832112.93770269
15,1,2,1,4,8,1508276.35925562,7369808.60698861
27,3,1,0,4,8,2058622.79043202,5766618.908954
29,3,3,2,4,12,1685444.09399007,6452649.425068701
39,4,2,1,3,10,2070128.30490856,4471565.82844474
10,6,3,0,2,11,2193453.43505159,7356368.01476376
26,3,2,1,1,7,1923415.50365797,4668156.2503488
16,5,2,0,5,12,2441808.69728966,6909603.40105758
12,3,1,1,1,6,1525735.24037075,4588796.99563554
28,6,0,1,7,14,3108390.42770471,7449545.27095762
40,1,3,1,7,12,1609884.26436996,3304563.10694108
18,3,1,1,6,11,2118622.1801176,9627993.5719614
39,6,0,2,4,12,2424580.90019677,9921653.73967883
34,2,3,2,6,13,2365487.23017229,5707905.19048096
29,1,3,0,7,11,2364598.38980301,6341466.721753401
11,1,3,2,1,7,1479491.30806256,4799393.33227634
12,3,1,1,4,9,1683757.73134681,6957017.77425526
15,0,0,2,3,5,1341947.71678648,3229777.75445359
10,6,0,2,1,9,1588676.39326173,8081413.01459733
31,5,0,2,0,7,1626291.60382706,6633628.21407256
35,1,3,1,7,12,2091023.78148496,5751618.18497442
22,3,3,0,6,12,1610367.2114188,2856709.98519331
17,6,0,1,2,9,2469725.90353648,8164323.28327846
16,6,2,1,7,16,2807025.1756637995,9373838.84595364
27,0,1,0,3,4,1349801.50017139,7501701.95843675
35,2,3,2,2,9,1535970.8341754999,6173630.29120805
16,5,1,0,6,12,1860314.98135134,7124484.90368551
16,3,3,0,3,9,2234300.96148813,6431844.3036567
33,4,2,1,6,13,2738078.85444116,5519936.40662818
26,3,3,1,6,13,2662401.1709424,9691177.07393839
24,5,0,1,1,7,2015474.76186131,8957662.9362694
36,1,2,0,4,7,1820082.58669469,2960871.10691674
31,6,3,1,2,12,2270826.85643403,7419499.58710945
33,0,3,1,6,10,1879400.10971233,5346595.92268264
39,4,0,1,0,5,1496117.06277389,4235610.99786903
26,4,2,1,7,14,2203232.17898055,3192831.22644204
17,3,2,1,2,8,1985118.26792743,4754890.29198679
35,3,1,0,3,7,1895654.87939153,3704514.78986384
40,5,1,2,2,10,2522569.44968941,10434356.837864399
11,3,1,0,3,7,1487301.54883031,5538599.77506151
20,5,1,1,2,9,2009212.91257902,5620293.27391549
27,4,0,1,1,6,1869336.59218059,6038041.87345218
23,1,2,0,7,10,2167631.40342406,2298466.12525238
37,3,1,2,6,12,2714457.05401572,5236347.02580944
12,2,2,2,5,11,2000570.87442159,10152340.9821289
26,6,2,0,4,12,1578311.14794373,7257914.22882117
35,4,3,0,0,7,1575081.58081223,4524452.07671668
13,1,0,2,2,5,1581857.05548319,4581916.3040891
35,5,0,1,1,7,1523502.18037124,6238512.89848839
37,1,0,1,1,3,1294998.37281782,3375570.93703973
22,3,2,2,4,11,1806078.80499099,4386994.54084727
32,6,3,2,5,16,2147363.73096426,10232607.1104405
35,5,0,0,5,10,1924972.21804913,5738630.35815617
14,6,1,0,4,11,1961154.52428739,6232657.44534431
38,3,3,1,0,7,1932561.40178616,9746604.68385966
15,3,2,2,2,9,1808230.89990237,7091343.22510859
19,0,3,1,3,7,1562634.16121147,2018795.67814751
39,5,0,1,3,9,1181397.74971734,6236071.29984335
26,4,3,2,2,11,1922475.50963007,2834046.68979613
26,5,1,1,1,8,2017075.43444493,4768337.11390782
11,1,0,2,0,3,1361642.76228101,4933884.08002597
21,4,0,1,0,5,1551743.37051821,5071318.93632625
16,0,3,2,5,10,2057857.95843028,5153136.78234146
26,6,3,1,1,11,1751893.49267666,4661761.91879515
24,2,1,1,3,7,1853936.1624262,8382874.41532545
36,5,1,0,5,11,1941585.89857838,6588443.209633401
31,6,2,0,2,10,1718930.7714722,6407035.52600529
33,0,0,1,7,8,1978728.01567236,1780139.73175964
35,4,2,1,7,14,2063004.80557476,9322637.04874022
14,4,3,2,2,11,1765608.36840948,9668988.14584555
31,1,2,0,6,9,1997102.61647945,6762462.502441299
17,3,0,2,2,7,1893773.61983263,7185550.58125285
15,5,2,1,0,8,1536854.90950024,5999410.32230911
32,0,2,2,4,8,1782212.2216063999,4227795.94193855
32,1,1,0,5,7,1870559.33789265,5582558.41263489
16,1,1,1,1,4,1005521.28896557,4264057.5160876
15,5,1,0,2,8,2257124.45084372,2437565.33559866
19,5,0,1,5,11,2342238.18989378,7221993.82689385
21,2,3,1,7,13,1782053.52542142,5874803.77515781
28,0,0,2,4,6,1436104.3298574,6239599.52567467
15,1,3,2,6,12,1999101.11010239,6915252.64744089
10,6,1,0,7,14,2606989.40672267,8083517.62754071
21,5,0,2,5,12,1847064.84893647,8835434.80398842
40,3,3,2,0,8,1540388.63316679,2163074.68320522
27,1,2,0,3,6,1781007.65152955,5568968.86098446
33,5,2,0,2,9,1845387.43401306,4489331.19022177
21,3,2,2,4,11,2338938.03902276,6494645.91779426
33,4,3,0,2,9,1663600.65659634,6082820.95096645
16,5,3,1,0,9,2090434.26648306,8405760.15470305
23,0,1,2,2,5,1832806.76098899,4028129.42552591
16,6,2,1,5,14,1654964.3745786,8464290.73964955
29,4,3,2,4,13,2366850.48116453,5823812.81050668
37,1,2,2,4,9,1904511.01678711,5922751.5707235
22,3,0,1,2,6,1573897.65179474,4914681.83946647
19,0,2,1,7,10,2186611.12836714,4941765.96718587
30,3,1,0,3,7,1859189.69180242,5229119.01679107
21,1,2,1,1,5,1851874.5824929,5037643.78680946
31,3,3,2,7,15,2997876.34897256,5531623.07446809
15,6,2,1,4,13,2956354.23818589,5679106.0977040995
12,2,2,1,0,5,1704169.60066127,3410117.90751741
16,1,0,2,5,8,1573849.71151262,4378135.73116528
35,3,3,1,3,10,1598632.94025141,5775575.12387319
21,5,2,1,5,13,2141003.96874173,11757166.501293901
37,6,3,2,1,12,2228088.4970415,5863349.99410075
29,1,3,1,6,11,1908092.22515023,6968387.54950663
22,1,3,0,7,11,2130870.45267879,3380048.71702537
29,0,3,1,2,6,2005404.9529643997,5044850.70721604
36,1,0,1,5,7,1663791.72439971,2739529.16083214
24,0,1,0,0,1,1181065.4715526002,1546180.15823538
32,4,0,0,1,5,1391522.02242742,6420648.43402993
27,4,1,0,2,7,1050414.0797874,4947637.57194067
32,1,0,0,2,3,1230728.87112666,4029487.68778252
34,0,3,1,2,6,1676947.91603509,4522336.80431815
28,2,3,0,7,12,1500781.08815602,8047106.80013073
24,3,2,2,1,8,1892546.25229562,6628130.94333992
22,1,1,1,1,4,1240490.38404105,2259650.94533677
17,3,0,1,3,7,1670378.02401203,4613660.05489806
17,3,2,1,4,10,1924520.27471188,8242512.10097108
17,4,0,2,6,12,2765691.97383597,2765691.97383597
39,3,0,1,3,7,2097038.10045265,3434567.91442295
23,4,1,2,4,11,1863921.60797373,5131382.85881936
25,1,1,0,5,7,1527509.12646709,1781020.94881648
35,6,2,2,6,16,2672394.95848669,7672606.9455821
30,5,0,0,3,8,1616708.1629098998,4292105.46836304
27,5,2,1,5,13,2098214.13603182,9969423.04987763
12,5,2,0,1,8,1939748.78096398,5878896.51516935
13,1,2,1,6,10,1896472.54555728,3448852.2766019995
27,0,3,1,2,6,1421205.7119785,1379718.46103137
34,3,3,2,2,10,1835919.42567734,6921954.78702685
26,4,0,2,0,6,1687441.47277249,3064827.86399435
25,3,2,2,0,7,1406600.41990434,6835488.05558936
39,1,3,2,6,12,2864087.12553451,8390842.24399831
39,4,3,2,7,16,2709572.3367628,8901920.09851898
21,6,2,0,3,11,1596229.1321907,7776661.06276285
21,1,1,2,1,5,1736124.92407347,5286681.50460769
18,1,1,0,4,6,1588571.60978631,5993417.90079985
39,1,2,1,2,6,1615883.66336876,5064322.55077767
18,5,3,0,4,12,1414053.50872775,8133682.95961647
16,0,2,0,2,4,1592157.33000749,2733578.61714919
40,3,0,1,4,8,1405199.01433718,5307099.86984355
26,2,0,0,5,7,1654372.98078537,5835170.6428335
31,1,1,1,2,5,1533907.08778431,3204988.78653096
18,0,1,0,4,5,1663885.71671627,6842003.79259156
21,0,1,1,3,5,1787660.33673468,8042098.646801401
28,5,0,0,1,6,1837438.97831132,3588275.56472066
34,5,3,0,2,10,1934700.44271741,9459506.00959191
37,2,2,1,0,5,1668089.97944442,6272126.41227372
21,6,2,1,3,12,2477029.38552824,7490044.76289263
20,6,0,2,7,15,2949434.10480306,9348077.26096229
29,2,0,1,1,4,1365385.42389323,7511167.98156408
39,2,3,2,5,12,2088298.63134669,6374197.50366007
28,2,3,0,3,8,1797137.49957254,4342952.42588227
28,6,3,2,7,18,3613318.14034621,6953667.14292887
12,1,2,2,1,6,1340426.2336722,4045712.34102139
36,6,1,1,6,14,2695676.64129567,6482053.68792954
36,3,0,2,5,10,1859532.07690236,5843327.88526608
12,0,3,1,5,9,1489559.54316797,8100165.28520916
40,0,1,2,3,6,1390015.95020933,5524624.01414002
18,2,3,1,7,13,1938819.75265733,7385463.28478195
31,6,1,2,7,16,2323052.36730547,9959298.81493973
32,0,1,1,1,3,1460207.81523777,6059877.63867168
21,6,1,2,1,10,1889704.82063318,9515660.79531008
32,4,3,2,0,9,2106756.06685167,4062565.99322149
38,4,2,0,4,10,1820192.64591307,4377539.52119938
37,3,1,2,6,12,2184701.83543845,7444418.45206748
38,1,0,0,2,3,981880.9621687271,4825029.18595846
37,4,3,2,5,14,2237812.72184622,6094222.06138246
15,0,3,2,2,7,1649922.61087975,6320806.00568637
37,5,0,0,2,7,1078881.87088275,7500601.69526079
35,3,1,0,3,7,1637057.15558395,3291263.0208003
23,2,3,0,6,11,2214208.62601819,6746415.78843603
10,2,1,0,2,5,1431297.70027054,6595391.02023329
11,5,2,0,1,8,1575830.02321473,3463230.55364352
19,4,2,2,3,11,2254791.79110717,8559586.5105734
15,0,1,1,5,7,1670897.41092786,3793047.55999719
22,4,2,2,2,10,1876719.33613026,7069286.532304401
29,4,2,0,2,8,1946329.61126608,4194225.98978059
37,0,2,1,3,6,1377172.20391763,5655105.13309039
16,3,1,0,6,10,2334681.26810795,7183601.274072
35,5,0,2,5,12,1873671.06499395,9029935.59831065
27,4,3,1,2,10,1998196.05117637,6757687.60114659
14,1,0,0,7,8,2137488.45265636,5832971.30098804
24,4,1,2,0,7,1436765.92905137,5969459.18811265
23,1,3,0,4,8,1818549.70648424,6848969.60499701
15,6,1,0,6,13,2562383.03436905,8537972.79262725
12,3,0,1,5,9,1812685.90208363,7160405.41408676
30,3,0,1,0,4,1646826.00938911,8058253.90210957
15,5,2,0,1,8,1765160.08802003,8484457.97654749
24,6,1,2,2,11,2814899.89768482,9455444.24916493
24,4,3,0,2,9,1806489.79690812,6153558.8575527
35,4,2,0,7,13,2447724.12809879,9625288.22238484
35,1,3,0,6,10,1720957.38458811,7295959.65755736
19,2,3,0,0,5,1614587.97252506,4191646.69305832
21,4,1,2,1,8,1851694.40085717,3357558.38878787
10,1,2,2,2,7,1896916.93160588,2895176.77160845
33,4,3,0,6,13,2714563.57067659,4977599.88857211
36,4,3,0,4,11,2219728.61880867,6339261.36167925
18,0,0,0,2,2,1013343.19379011,3179345.16708947
18,4,3,1,4,12,2661072.89796836,5135274.17306828
19,3,2,1,4,10,2125606.84619627,5648034.09866441
10,3,3,1,4,11,1506095.56987085,5616040.36978195
34,0,3,2,5,10,2264083.17132041,6084630.60924806
14,3,2,2,2,9,1690198.25254818,6715773.39255438
27,1,2,1,5,9,1941964.34209646,6531224.48598748
38,4,0,0,5,9,1465562.68508327,7638773.12422795
21,2,1,0,2,5,1579089.70801528,6691877.43681541
29,0,1,0,6,7,2128543.66015432,5928574.35072694
37,6,0,0,4,10,1954191.20334297,7289862.9795804005
36,2,1,0,3,6,1275097.87577183,2316592.7669169996
14,0,3,0,6,9,2127844.65568294,6406098.01362973
37,5,2,0,1,8,2376474.72656241,2960008.77219936
35,2,2,1,6,11,1577646.38179523,5591084.67085613
19,0,2,0,6,8,2248306.4033302995,6351765.22728411
17,5,0,1,1,7,1772061.40662224,4507079.5809385
29,6,2,0,5,13,2329885.95674683,5884469.89573173
38,6,3,1,0,10,1837137.76079875,2933738.2650403
20,1,1,1,0,3,1171572.62820395,2610551.40624494
33,4,1,0,2,7,1791535.94831139,3972091.38894261
11,4,3,1,6,14,2288266.62570786,10007843.083333999
38,6,0,0,7,13,1751583.58425716,4868483.58205245
16,6,0,1,5,12,1829930.59678056,7129998.43751184
27,1,1,1,2,5,1678001.76954505,1848442.87456103
35,2,0,1,4,7,1763168.78129102,2108940.49406442
21,4,2,0,2,8,1069455.91014819,5510810.4211242
39,3,2,2,1,8,1233382.06501499,5627267.76183979
39,3,0,0,5,8,2000584.62004258,7660801.84383317
30,3,0,1,2,6,1491342.96126291,5498166.25588547
12,3,2,0,7,12,1789542.3418868,6703523.67360821
28,4,3,0,2,9,1702454.46507821,8679886.56329224
26,4,0,1,4,9,2075783.89604844,2102623.21871005
34,3,1,2,3,9,2268456.36218847,3474085.93031423
40,4,3,2,4,13,2615679.40877526,5078912.34024796
14,4,1,1,7,13,1943584.70597366,7551087.20882128
36,2,3,1,0,6,857504.74440185,3831528.73080722
37,0,0,0,4,4,907981.466824154,5777851.78150273
39,1,3,0,4,8,2191646.25838535,5403213.54864829
36,3,0,1,7,11,2511779.82221306,2740771.95411358
29,0,3,0,5,8,2261406.84946853,6078487.283088099
33,6,1,2,3,12,2069470.86295628,6646195.38397156
32,1,0,2,1,4,1094085.96116223,3531661.32776513
28,0,2,2,4,8,2087144.16877722,4757764.06307173
15,1,2,0,6,9,2002631.31053302,6369019.5007046
38,1,1,0,2,4,1396792.47649958,5510885.17926126
20,0,2,2,5,9,1755379.28773448,4742685.83940438
37,1,3,1,2,7,1704181.14331923,5479020.848272401
31,6,0,0,6,12,2944834.42950213,6448557.01787539
19,5,2,1,7,15,3048236.09343825,2580648.0515812
25,2,0,2,4,8,1880320.57426929,4755415.61599222
39,0,1,1,5,7,1601059.25837029,3834946.32452876
30,4,3,2,2,11,1703847.97851331,10657865.9699158
27,5,3,0,2,10,2188013.64106432,3662189.22301584
10,2,3,2,0,7,1868574.85270034,3968226.4968094
12,6,3,2,4,15,2911192.13736784,5382818.31625083
10,0,2,0,6,8,1677428.99586243,7118022.94211752
10,1,1,1,2,5,1249164.55992801,2363452.07406261
32,1,3,2,3,9,1794405.47549986,6785035.95136751
23,0,2,0,7,9,2232190.64362466,6071134.92288227
30,0,0,2,5,7,1338142.48870088,5466313.02365174
39,1,0,2,7,10,1826131.10138104,5477009.29857509
10,0,3,2,7,12,3060404.68915979,6715871.11455431
39,0,3,1,4,8,1430712.05157579,6496373.44591012
27,6,0,2,3,11,2224915.37543681,8168316.83016157
22,3,0,2,2,7,2053389.92305279,5008080.40353786
20,2,3,0,7,12,2573791.40892453,6658866.293232599
29,1,3,2,0,6,1795745.57630609,8593769.5587037
32,6,0,0,2,8,2257701.03608463,2182411.58656245
15,6,0,0,1,7,1663985.91773958,7598893.28901922
37,1,2,2,5,10,2139598.59059377,6046689.69724498
22,3,3,2,0,8,1336065.3942735,6937745.21711268
30,4,2,0,4,10,1993147.213182,3507057.19027567
18,5,2,1,7,15,2159146.59303045,4010344.50104988
16,2,0,1,2,5,1445576.63941565,4390705.65682969
13,1,0,0,0,1,1084572.94183922,4222286.53430726
16,5,1,1,4,11,2113771.91482864,8593031.77252278
25,1,0,0,4,5,1433001.75426074,4516454.29357362
39,4,0,1,5,10,1677248.43737665,8572732.32157491
10,2,3,1,7,13,2519630.28474734,6560968.22212218
31,5,1,0,2,8,2077856.31359101,5060476.24694367
21,3,2,1,4,10,2064762.63935778,9305568.351389
24,3,2,0,4,9,1553709.08657901,9024532.15159046
28,0,2,2,1,5,1454692.24682967,4582624.86444525
23,1,1,2,6,10,1476487.21436526,7014687.07462795
23,0,3,0,2,5,1885288.42874644,4637672.93914619
33,4,2,0,2,8,1800017.19984697,4395858.2106929
26,1,3,0,6,10,2119719.68063693,7596939.63244946
20,1,3,2,0,6,1628518.45599314,4371330.40474715
12,1,1,1,5,8,1393690.06048999,7874862.09421589
11,5,0,0,2,7,1876097.13820869,3215856.78263247
34,4,1,2,3,10,2557380.77007044,5389414.47593975
31,6,3,2,7,18,3047721.95979848,9290031.09484019
20,2,3,0,2,7,1501678.80270513,5872697.594491299
15,0,0,0,0,0,809954.593413069,3437082.11466145
20,2,0,2,4,8,1328808.67301249,4271528.17080751
10,2,0,1,0,3,1460278.99390592,3394744.61561834
35,1,2,0,3,6,1916597.58903996,6182514.64166888
37,5,0,1,1,7,1739226.76402291,3932506.09718462
23,1,2,0,2,5,1006895.07291039,3286975.47705855
14,0,1,1,1,3,1213251.862194,3904933.40402152
35,2,3,2,2,9,1882758.32175688,7933253.7026357
38,0,3,2,0,5,1634583.48915695,3597831.3567716004
32,5,2,1,7,15,1647036.09028136,7284171.8428119
13,5,2,0,5,12,2324395.65798732,9226568.86914692
22,2,3,2,6,13,2598498.90054978,5635730.47210133
24,0,0,0,7,7,2054055.5182659,5872319.81066354
11,3,0,0,4,7,1496011.13641125,3159588.47109305
23,6,2,0,6,14,2409882.09958552,6883292.18500071
16,6,3,1,7,17,2190924.33478233,8802085.59687599
19,0,0,2,3,5,1534718.2059096,5245193.15919281
28,4,0,1,4,9,2379312.71670272,6552440.39172474
11,1,3,0,5,9,1851608.44728443,4793089.97632668
15,6,3,1,6,16,3130994.81596788,11270637.6063805
27,2,2,2,7,13,2575495.28590253,5695177.69593164
30,1,0,2,0,3,1358723.04052469,5325778.09354928
15,6,2,1,0,9,1737069.45881563,7862621.45597154
18,5,1,1,2,9,1276348.26021259,5722873.94084555
32,6,1,2,7,16,2198487.16502362,10882787.2001132
10,3,1,0,1,5,1376243.05615168,3193607.52216667
22,5,1,0,3,9,1655701.85976997,5933765.46807464
13,5,2,0,0,7,2067512.69793101,9138679.96320673
15,1,1,2,5,9,2327234.70994048,5621685.44483814
23,4,1,2,5,12,2383582.68025903,6523210.95175184
11,5,0,1,6,12,1944529.54611732,3468165.31152246
32,3,1,1,0,5,1242293.3551047,5912284.7317617005
15,3,0,1,1,5,1598107.36133104,1598107.36133104
30,5,0,0,5,10,1710442.69733219,7098737.4016169
26,4,3,2,2,11,2481231.46706186,9088521.4299102
26,4,2,0,4,10,2003607.76931226,3588822.01141794
27,1,2,2,4,9,1920579.51957107,3044270.30276421
37,1,0,0,2,3,1532715.79232997,1655406.45244045
15,3,0,2,4,9,1994304.81366563,3848095.19015251
40,0,1,0,3,4,1345473.57625887,1389890.98406053
29,1,1,1,7,10,1822464.91153764,6860954.25468202
32,1,0,1,6,8,1421368.91139914,3153640.93979107
25,6,0,1,0,7,1938655.45358571,4682150.71671803
11,2,1,1,4,8,1851327.42534095,3366966.83310304
23,4,1,2,1,8,1372151.34883695,6194634.39686585
29,2,2,2,1,7,1435184.52408958,4489771.5146827
30,1,3,0,4,8,1309409.8981313999,5547402.84492313
22,2,2,0,2,6,1902201.17890085,2786185.39204733
35,1,3,1,3,8,1698538.30514079,8637985.81786179
38,1,3,2,4,10,1962338.38335061,8364635.04360486
38,1,2,1,3,7,1431826.84783928,3765313.86682312
35,5,0,0,3,8,1784400.16657062,4030259.74745185
38,6,3,2,4,15,2136190.45594742,4687555.92058318
30,5,2,1,3,11,1920609.56124635,8061636.00427096
16,5,0,2,6,13,2511382.0059164,9877342.47418131
36,2,2,0,4,8,2153724.4504168998,6444439.75423458
35,4,1,1,6,12,2297626.54638916,7952130.455847099
11,3,2,2,1,8,2106216.63233731,4971975.98028186
33,5,2,0,4,11,1995566.7272009999,3996499.49383465
23,3,0,0,0,3,1049119.73963736,3225945.51442453
14,2,0,2,7,11,1290811.22781888,8025726.33592949
21,3,0,2,7,12,2573205.52451725,5623298.71067956
35,2,3,1,1,7,1671661.42691386,7124685.02250691
29,2,1,0,2,5,1768415.30728181,4886113.0444007
33,1,3,1,7,12,2143270.37948475,6028278.79636483
37,2,1,2,6,11,2087450.64265692,7078849.25142914
29,6,1,1,0,8,1534739.74270146,5562386.68465017
20,1,0,1,2,4,1388286.07764938,4772647.26711071
13,2,3,2,2,9,1400825.25663955,3490776.11176083
17,4,1,1,2,8,1496479.67628568,5909283.44983029
37,5,0,0,7,12,2285535.97665305,4913209.26108142
31,5,3,1,4,13,2118851.97499184,9087177.23434063
36,5,3,0,1,9,2262524.00713616,4616044.98697085
33,4,3,0,7,14,2355132.57503671,5424415.6505531
31,1,2,0,1,4,1717533.34883265,3891390.09161598
38,2,2,2,7,13,2115049.77714472,4545416.95011732
19,3,2,1,4,10,1594511.82921476,9346305.71708866
19,0,1,1,6,8,2017361.83623946,4947872.70032104
25,5,2,2,4,13,3030587.11702619,5085279.494118799
33,1,0,1,1,3,1204489.428329,6274657.21924036
37,4,3,1,3,11,2237027.70434219,7842419.37213095
11,3,2,1,7,13,1928698.32788953,7309427.69275304
12,2,1,0,2,5,1668980.53311006,5300642.18414276
39,3,1,1,6,11,1769499.64105911,6213776.67180723
22,4,2,2,7,15,2492465.11097698,8291242.26680631
36,6,1,1,6,14,2568010.09649326,7771543.64822586
25,3,0,0,6,9,1889120.46988762,4780368.94329732
35,6,2,0,1,9,2240972.82583171,6924258.74479028
27,1,2,0,4,7,1503003.76850663,4172576.43502357
31,4,0,1,6,11,2125934.15402665,3025802.93534007
37,2,0,1,2,5,1606713.27839777,10469579.661702802
21,1,2,2,7,12,2221349.83923807,6722229.4651854
35,0,0,1,3,4,1412523.09417493,5048196.96527114
14,2,0,2,3,7,2293565.57275178,6885093.08257804
39,3,3,0,6,12,2155839.26882715,8759891.132122701
36,2,0,1,6,9,1634483.99786937,7532069.21551333
19,5,1,0,7,13,2121380.62736805,8772263.58679
10,0,2,0,7,9,2487775.09543896,6254427.06327755
19,2,1,0,7,10,2049103.28553899,5373976.45699533
14,0,2,1,1,4,1436280.04721262,5084799.04456685
14,1,0,1,4,6,1341497.60208828,5051878.89849383
31,1,0,0,4,5,1664970.44513884,4336162.56370793
31,4,2,0,5,11,2164108.19982293,7235149.73193289
32,2,2,0,4,8,1191577.39723627,6045712.4771931
40,3,0,1,5,9,2131244.2792988,6066926.45688263
11,5,0,2,4,11,2309753.2813568,6454111.74489878
25,3,0,2,5,10,2226867.23680178,6266026.91591121
22,6,3,2,7,18,2361095.71179769,8232011.47459302
20,2,0,1,2,5,1256303.6393981,2543764.57951839
23,1,0,0,0,1,861167.034736588,3968659.73498702
25,3,3,1,2,9,1684786.75699653,6383582.99903824
38,1,2,1,3,7,1550464.49940371,5322115.65393482
32,6,0,0,5,11,2096180.95176721,6851429.86596681
14,1,2,2,4,9,2304733.7159033,3699562.84930772
26,3,3,0,2,8,1489906.63721338,4347659.96387336
28,1,2,0,1,4,1206503.03058046,6409807.558368
29,1,2,1,5,9,1762123.0045479,4431069.50933781
38,4,1,1,2,8,2198258.74875158,5592200.38926062
24,1,0,2,0,3,1533607.17742015,2996038.37319142
11,3,2,0,2,7,1765299.3271896,5959553.19324101
34,4,1,2,2,9,2107109.09285157,8471601.62714513
25,1,0,1,4,6,1883518.69899133,4784858.51104371
30,1,3,0,3,7,1528081.16848456,5881363.45249835
13,4,2,2,0,8,2109123.00650243,4048844.02170823
39,6,1,1,7,15,1822111.65934595,7747284.51811732
32,4,1,1,4,10,2417083.68846666,6098860.74897225
12,3,2,2,6,13,2353039.61694216,7375715.3261681
34,1,3,2,5,11,3234435.13337235,5787724.84277601
11,6,0,1,3,10,2604400.9691621,8930055.164344901
33,0,2,1,2,5,1555615.26231188,4664652.05043656
25,5,3,2,4,14,2239837.60822741,6344462.08761006
33,3,3,1,2,9,1685835.73597176,6068558.88161991
16,4,2,0,6,12,2839954.41057189,8553363.38992809
25,3,0,1,3,7,1775119.78684363,4829305.5612035
22,5,2,1,7,15,2475314.01656892,11981588.2625983
20,2,1,1,6,10,2219148.19964498,4360146.00762739
21,1,2,2,5,10,2036194.81091349,6774242.4369431995
40,0,1,1,3,5,1491685.31942137,2758987.20710675
11,1,0,2,6,9,2207426.00163919,1993959.5705986
16,5,3,2,2,12,1740665.35180555,6506549.14343
16,2,1,1,0,4,1365809.26326319,5034951.68912724
26,2,2,2,1,7,1770709.48013255,3761803.79047209
12,0,2,1,1,4,1618721.16028557,3951598.63744443
18,4,0,1,6,11,1873251.83206994,5880826.82626948
31,5,1,0,3,9,1676771.12535579,6253047.91372366
24,3,2,0,4,9,1612330.88707286,2551609.17220113
17,1,3,1,1,6,1479055.05124041,4979091.09015113
18,3,3,1,5,12,1796753.95557991,6572602.70895916
18,4,3,0,6,13,1961190.29408229,7990185.49260858
26,5,1,0,7,13,1700336.51025615,5512078.58699179
19,0,0,2,1,3,1180313.43651012,3130711.41484336
23,4,2,2,5,13,2837554.03118162,4182162.31105373
40,6,3,0,6,15,2186044.29723535,11391468.896269199
28,4,2,1,0,7,1863598.4087209,5628511.86710164
25,3,1,2,2,8,1724415.37143871,3032834.08649757
11,5,2,0,2,9,1620053.21986764,5729652.83892719
25,6,2,1,2,11,2077972.69935106,7212521.89200167
19,2,3,1,1,7,1618895.8126824,2841490.92198885
35,2,1,1,4,8,2401968.39439939,6780585.18112698
39,6,2,0,2,10,2004382.13117506,4354895.38490781
31,5,0,1,0,6,1552193.88976185,4471285.06981783
35,1,0,1,6,8,1571437.33189686,4080201.10195334
28,1,2,0,3,6,1321334.50233128,4675225.68507334
22,4,1,2,4,11,1680250.95733017,5523581.20715202
21,2,2,2,7,13,2073358.73914651,7866764.16109277
22,0,3,1,3,7,1649766.55480033,4257131.85886736
33,5,1,2,4,12,1772253.52176717,8498578.55403251
26,6,2,2,5,15,2618973.67552262,8792201.16428116
17,4,2,0,5,11,2743890.90184436,5999052.65602854
23,5,0,1,7,13,1829086.5372799,9265042.90644428
16,6,1,1,5,13,2474092.18476206,6864139.27356049
10,1,3,1,1,6,1907383.19430486,5556332.36334002
36,4,2,2,4,12,2421796.19946842,3886204.53984137
35,2,1,2,1,6,1797990.17672323,4348197.42622741
28,1,0,1,2,4,1733653.24612255,5175674.87639068
13,5,3,2,2,12,1502932.63316453,9525087.58192507
30,1,0,1,0,2,1607889.60799204,4833869.68865632
18,5,3,1,4,13,1434183.08201181,7704060.43317838
10,6,0,1,1,8,1490512.86068779,6870539.38850256
21,5,3,2,2,12,1971553.73288184,6069975.76926105
21,3,1,0,1,5,1263504.2822799,2718328.91981098
38,1,1,2,7,11,1908950.9106508999,7810837.77468834
35,2,0,2,7,11,2383165.04672449,5763980.12889171
18,1,1,0,1,3,1480946.7152806001,869354.972840603
40,2,1,2,4,9,1884846.20231624,6205900.51362421
34,0,3,0,7,10,2030010.62646322,6610430.94331501
14,2,0,1,6,9,1955328.63611606,6117098.4055522
15,5,0,1,5,11,2409869.03624354,3388528.48948895
29,5,1,0,2,8,1691778.93184963,4118989.52314834
22,3,2,1,0,6,1766394.74919513,7339713.04825429
23,4,1,2,4,11,2041144.16579662,6522695.53459174
40,6,2,1,4,13,2566579.86464869,5430741.91999347
17,1,1,2,1,5,1755037.74097579,3747392.89833235
17,2,1,1,4,8,1807056.87813182,5565162.16736273
34,4,1,2,1,8,1817441.12820203,160498.912256231
15,4,3,1,7,15,2330005.95872475,5474069.90333957
10,0,2,1,1,4,1711320.72422878,3068649.025416
20,4,0,1,2,7,1656765.33942082,1656765.33942082
24,1,2,2,7,12,2514446.43147694,9236799.91651836
25,1,0,1,7,9,2182269.10781711,4970189.59318478
40,2,3,1,5,11,2329164.74146755,5699438.00858121
17,5,0,2,2,9,1993260.44154418,4150932.52227039
10,0,2,1,5,8,1873762.96924466,5624446.08735861
17,5,1,0,5,11,2131282.0738653,7887604.43058341
28,4,0,2,0,6,1561606.83947235,5570838.738655999
18,1,0,1,0,2,1227644.48801861,2511308.13947696
36,1,1,1,2,5,1572609.90045073,5495349.30304182
25,6,2,2,7,17,2606310.63914293,7788525.27611462
13,6,0,1,1,8,1780927.50818221,3245310.18138571
40,1,2,2,3,8,2064323.65958875,5204088.25548155
35,2,2,0,2,6,1440225.55629489,1386902.41091906
38,0,0,1,7,8,1636327.16223927,6198292.52327277
31,0,1,1,4,6,1741686.31109556,5603196.1555322
30,3,2,0,7,12,2193667.43493408,7876037.110453701
20,5,0,1,0,6,1356114.09832874,4189157.59606429
40,1,2,1,5,9,1627468.63462961,5701025.85827907
27,4,2,1,2,9,1444221.55540456,7267328.43540914
23,2,0,1,7,10,2291560.07865965,6831962.45286312
25,0,3,0,2,5,1127836.77193858,7709855.72258348
39,3,3,2,7,15,2725443.40145062,7915919.54981239
33,1,2,2,7,12,2499244.99866766,3745238.4354705
39,3,0,1,5,9,1421298.04694345,3313763.29887012
11,6,2,0,1,9,2200224.26351873,4707754.55719982
15,2,1,0,1,4,1612443.52078336,10469894.2477029
10,6,1,2,5,14,2989327.81060198,7649924.85117309
17,6,1,2,4,13,1872398.09415384,3417457.15260798
11,0,1,1,6,8,2116548.56062774,6646377.57230983
12,2,1,2,7,12,1983483.67217503,4495516.56043098
31,3,2,1,4,10,1528682.66917298,5960421.11474959
39,6,2,2,4,14,2949074.67485301,7794429.37020979
28,4,0,1,2,7,1462127.38329545,6777423.57934205
23,5,0,0,0,5,1185756.62383736,3840064.9805226
33,1,0,0,0,1,980235.090400955,4271737.28121759
38,5,1,1,2,9,2148726.31579141,5962987.98654339
26,2,3,2,3,10,2140878.49316667,4097733.30144931
21,2,1,2,5,10,1842084.19763557,8748858.16188186
14,6,0,0,7,13,2465111.17718984,9568432.65109944
18,5,2,1,2,10,2289662.81964973,3815149.38920572
29,4,3,2,4,13,2301680.87384024,5783948.88972431
13,5,0,2,4,11,1721413.21393637,6298757.06135507
18,5,0,2,0,7,2067489.11042084,6460745.00362853
20,1,0,0,0,1,801864.752107069,4609283.0063311
34,5,3,0,7,15,2842759.14650566,4787926.80200776
30,4,2,2,5,13,2448701.62992993,9792715.76113866
21,1,2,0,2,5,1515574.7283126002,4745605.86102926
26,3,1,1,2,7,2266966.09678522,5174487.16153966
25,6,0,0,5,11,2356337.06519771,5174494.45477111
28,3,2,0,5,10,1998884.11100489,7425516.93477418
31,1,2,2,1,6,1743928.48866031,6629011.67664531
36,1,2,1,2,6,1972756.31129807,5176954.41302358
13,3,0,1,4,8,1639640.04962129,5724298.79037275
25,5,3,2,3,13,1810435.21247572,7013993.31603801
39,0,2,1,5,8,1734119.82163427,5627510.06147797
21,0,3,1,0,4,1444681.98770938,642339.232904659
19,5,2,2,6,15,2747553.46242016,8853004.56132135
23,3,1,2,4,10,1961019.19385817,5924100.17084624
31,6,1,0,5,12,1601580.68555496,6262888.62268705
30,6,3,0,1,10,2370042.10609124,6885644.98903331
12,4,2,2,1,9,2226820.57220231,11063783.1195997
34,5,2,1,7,15,3105061.92050129,6795498.89128828
38,4,2,1,6,13,1805792.01953319,6585507.53778902
29,3,2,1,5,11,2011781.41828631,3670810.21047786
15,4,1,0,4,9,1764798.45400866,7583078.826752701
29,2,2,0,5,9,2192435.12590342,9584813.38448443
29,2,0,2,3,7,2157699.41973233,4339422.3899969
40,2,3,2,7,14,2567560.56959081,7945242.76813047
32,1,2,2,0,5,1404718.26361903,7351094.12881113
31,2,1,2,0,5,1401032.64396136,6596459.63540461
23,6,2,1,3,12,1655090.04304203,4661521.01076233
30,0,1,0,4,5,1964035.83396572,5468276.4645609
35,1,1,0,1,3,1300924.16489754,1972190.28943923
33,0,2,0,5,7,1830064.15114808,7862779.23541815
26,2,3,1,4,10,2646356.85376327,9362202.726986999
31,0,0,2,6,8,1795154.0650435002,2253525.83775543
31,5,3,1,3,12,1990856.42762632,7150965.163242799
10,4,2,2,3,11,2198980.70767514,8323097.7684666
21,1,3,0,5,9,1412814.82074703,9137891.97427241
33,3,2,0,7,12,2613607.46503029,4363043.80412808
15,5,0,0,5,10,1488554.17076437,6505472.09535495
24,5,2,0,5,12,2193502.76350249,8142222.79706323
12,3,1,1,1,6,1865787.98202712,6035928.27732252
35,6,2,2,6,16,2279985.38122115,10856209.3028045
28,1,3,0,1,5,1877866.02900438,592405.44350516
23,6,0,0,0,6,1219927.55126192,9465035.33208074
27,5,3,2,1,11,2119842.1905086003,6789667.38965222
10,6,2,0,6,14,1534873.35937267,6431296.28831733
35,4,0,1,2,7,1544295.1651889998,2046528.11687917
35,6,1,2,5,14,1787198.84394092,7192683.317118401
13,3,2,1,1,7,1263866.66100594,5412344.75394166
23,4,3,0,2,9,1197521.25427632,8330376.30450901
13,3,2,0,5,10,2139833.77354571,5392384.68733396
28,3,1,1,3,8,1560391.64620592,3370638.66855179
28,5,3,2,4,14,1840804.52595138,8494711.25678933
20,4,0,2,2,8,1936617.64199591,3958800.60340048
29,6,0,1,7,14,2721286.88868055,9635087.22740595
22,3,0,0,3,6,1821491.45821255,4554876.99095353
38,3,2,2,1,8,1508440.42768494,6850499.05621965
26,0,0,2,7,9,1761738.50529605,4370205.66728002
12,1,2,2,0,5,943995.69114944,5302439.77988687
40,4,3,1,6,14,2727636.20713258,4667586.59348332
32,5,3,1,7,16,2796187.21917104,12564522.414932301
40,6,2,2,2,12,2257453.96061973,9029390.62372221
21,1,3,0,5,9,1631193.53313056,7720600.83202823
18,2,1,1,3,7,1548885.88550232,4581806.7727884
10,1,0,0,2,3,1216193.37267674,4827381.55130801
28,2,0,2,2,6,1600318.7243078002,5958660.94133547
34,0,1,2,6,9,2039369.34055851,4324612.35088263
39,4,0,2,3,9,2078191.20203453,10602645.0607488
24,4,2,2,0,8,1803836.60184209,6024385.51982518
15,6,2,0,5,13,2352421.26114394,11675507.251880199
34,0,0,1,2,3,1770559.35821409,2362592.1509622
32,2,3,2,3,10,1817264.22444117,6074474.57167517
28,1,0,0,7,8,1923561.68140174,6364704.22744535
12,1,3,0,0,4,1619159.51879086,5138585.4321074
23,0,2,0,7,9,1946501.16349945,4259546.28741955
27,0,1,2,7,10,2123169.74415239,12542496.2519522
23,3,2,2,7,14,1474979.52297582,9001762.04978687
22,1,3,0,6,10,1651069.17782857,5263773.65987048
30,2,2,0,5,9,1824391.48452368,7554794.24644221
10,6,2,2,4,14,2335932.31606943,6781188.84917604
23,3,1,2,6,12,2530025.99087471,8230363.759147099
14,5,1,0,4,10,1747674.9548483002,4940149.64577932
12,1,0,0,5,6,1693445.17425317,5521784.01130137
38,0,3,2,0,5,1235218.56741695,5319789.25435446
32,2,2,2,4,10,1779407.89560597,3483406.76355698
29,2,1,2,1,6,1422058.09330672,4974395.1559441
16,1,1,0,5,7,1633308.63817452,7160407.12404838
23,5,0,1,3,9,1855593.60256099,4130100.69518272
36,0,1,0,0,1,1030129.71331942,2984519.93338207
25,2,3,1,3,9,2216176.14418534,4292314.47772889
16,0,2,0,7,9,2391847.57363548,6579253.53718803
21,0,0,0,0,0,669712.030921871,1033168.68196854
40,2,0,2,0,4,1061719.20036929,4381053.8942257995
10,0,3,0,3,6,1516698.86298424,2672167.05895807
14,2,3,2,2,9,1885561.43670871,5256716.18664601
36,3,3,0,7,13,2381643.76768414,5203490.13978643
13,1,3,2,7,13,2167586.20890568,8367827.87696419
28,3,1,1,1,6,1843847.54661403,5950793.48024742
30,0,3,2,3,8,1305226.61836187,4806843.2454558
16,3,1,1,7,12,2245783.23433257,6943629.559211501
30,1,3,1,5,10,2618594.96589918,5359722.80055266
32,5,3,0,7,15,2253365.58505748,4040508.46859892
27,6,3,0,4,13,2617857.01817928,7495023.68712973
12,1,2,2,0,5,1721406.06877573,5810684.71263052
19,4,1,0,5,10,1604962.13561908,8397056.6594517
19,4,2,2,4,12,2071839.27254452,3280128.59483935
34,3,0,0,0,3,1548787.5054788,3303722.29443626
20,2,0,1,2,5,1790753.7538543,6682024.49430333
38,4,0,2,7,13,1808083.3715674,8372803.83181471
28,1,3,2,2,8,1841578.87525423,4998907.04981898
15,6,0,2,3,11,1958526.88897427,7750004.79692596
31,3,3,1,4,11,2459382.77302012,7489327.07010487
18,3,0,0,4,7,1639138.03792859,5693632.99743783
23,1,3,2,3,9,2473622.03001358,5427363.51091014
32,2,0,2,7,11,1902999.7501740002,2636421.68694521
28,6,1,1,6,14,2285952.4773089,8155355.25246791
25,1,3,0,4,8,1356767.65595591,6143141.39390968
31,3,3,1,6,13,2283141.22051826,3617095.53291355
12,5,3,2,6,16,1576542.73181621,6848917.32636962
27,3,3,2,1,9,2005833.49612392,6317090.98319014
19,1,2,1,6,10,2451406.43953928,5881071.997797901
21,4,2,1,2,9,1751242.18532855,6051881.29551074
21,4,3,0,5,12,2807757.94260688,6926193.91775255
37,3,1,1,4,9,1800337.8962647999,4866443.82943893
20,5,3,1,4,13,2035969.0337897,4504980.56308812
26,2,0,0,0,2,1532492.12233817,5618471.52028799
36,6,1,1,6,14,2345964.69896805,9098910.12554095
22,4,2,1,3,10,1964639.84332452,8516814.60738858
33,3,0,0,1,4,1223458.42978427,3565877.22188597
35,1,0,2,3,6,1780747.01162305,5398133.34007738
11,0,3,1,2,6,1468013.83705673,6736732.53863495
26,6,1,1,7,15,1939124.01420954,9711083.30844567
33,6,1,0,2,9,2572831.12810552,3871253.57855521
23,6,3,0,0,9,2100372.75551243,4940671.75904184
14,6,0,0,7,13,2213057.93748705,3038471.92511443
10,1,3,0,0,4,1226792.84317595,2347186.86982725
32,2,0,2,2,6,1522338.5155397,3668924.31887339
28,0,0,0,2,2,1429809.52046345,4574002.84464945
14,3,0,0,1,4,1709053.9669518,6356943.29497751
26,5,0,0,7,12,2803511.29010044,8671677.57537222
36,6,0,0,1,7,2342031.93817356,6346003.94320183
11,2,3,2,1,8,1811869.19339974,6862276.55646071
28,1,2,0,6,9,1457035.89669951,3713243.85572228
13,4,1,0,3,8,1473258.58201031,3426675.62070882
23,3,1,0,7,11,1733867.00095147,5661769.24428577
19,6,3,2,0,11,1994426.02265555,7034467.43866966
14,5,1,0,6,12,2311324.47007413,5979074.77524914
29,2,0,1,3,6,1881450.4894446998,3380604.57125902
26,2,3,2,5,12,2906071.41382414,6937811.15297027
30,5,0,2,4,11,1482826.53703888,4598697.69508484
13,5,1,1,4,11,1992379.49652215,3296596.63081601
39,0,0,2,1,3,1573103.33272921,5458478.0938969
17,3,1,2,7,13,2145973.39939151,8704494.25586643
29,0,2,1,6,9,1949054.79255213,3998511.3560426002
15,5,3,1,1,10,2099599.18438404,6375224.22508773
13,4,3,1,3,11,2050154.69676134,5004729.97879053
35,5,2,1,4,12,2630507.90536119,5488947.31828794
40,2,3,2,1,8,2182462.81657231,7444569.75874765
21,0,1,0,0,1,1141872.15651323,4200742.91480359
25,1,1,0,5,7,1591631.11547534,6657640.25694413
17,0,2,0,7,9,1896568.71290346,4653845.06238159
40,4,1,2,7,14,2565142.63813258,4600564.8572182
16,0,0,0,0,0,1171979.93266025,1076396.68131611
37,6,3,2,6,17,2496319.88461819,9018979.49424348
22,0,0,0,3,3,1459863.49738732,4380317.98127152
18,5,0,1,1,7,1953111.67529103,5833608.424767201
31,5,2,1,0,8,1366920.91048973,3296699.34915869
25,4,3,0,2,9,1522176.18672717,5509199.04197118
33,3,3,1,6,13,2926330.40278113,6835673.73868056
11,3,1,1,0,5,1487356.40137362,3444926.30518351
18,6,0,2,7,15,2458358.06985328,7276339.76487059
11,4,2,1,3,10,2094546.72166089,9266670.66390098
17,5,1,1,7,14,2689435.40184987,8593006.39083403
19,4,2,0,4,10,2155717.33680709,3422482.05498822
34,0,2,2,7,11,1698368.1329786002,5730972.71295218
16,0,1,2,1,4,1275311.90917012,3750867.39911308
40,5,3,0,1,9,2096859.95604735,6537833.27246976
37,5,0,1,3,9,1868666.36697102,7683725.78930848
31,3,1,1,0,5,1380924.32422352,6380577.2537419
25,5,2,0,6,13,2195573.5182778,10817859.353961699
27,1,2,2,0,5,1452944.84873678,6247922.12864623
18,2,3,2,1,8,1926195.38529335,4117388.23391622
32,0,3,2,3,8,1429914.43105289,4456972.26160061
38,3,3,2,6,14,2273917.80019715,7743700.62095689
36,2,3,0,5,10,1946139.03940654,7421371.962299299
38,0,2,0,1,3,1352177.04815711,5439955.9195939
37,4,0,2,7,13,1730121.90190819,8098659.62057971
24,1,0,2,2,5,1610487.32486848,5464875.3722553
27,4,1,0,6,11,1978776.70160474,1981172.5899541
31,3,0,2,1,6,1520780.46157206,5502329.476854701
33,5,1,2,0,8,1926520.51193368,6342220.51848208
28,5,1,1,3,10,2030643.18501171,7200202.53149165
10,5,2,2,6,15,2288713.67137904,5789874.0731199
38,5,1,2,1,9,1408460.68996893,4976792.45121909
15,4,1,2,1,8,1856041.68661516,6471274.53495613
32,5,1,2,6,14,1802301.49076739,7135885.09834649
26,4,2,2,0,8,1665888.4173413,4106985.81529974
10,3,0,0,0,3,1688883.21333048,664195.152158411
18,5,3,2,0,10,2139877.71337514,4620540.54995005
39,5,3,0,3,11,2512383.50928307,4913499.01190859
38,5,1,2,6,14,1957406.44866242,5518031.51571538
11,6,3,2,6,17,2341663.52965761,9083782.80863188
39,4,2,1,6,13,2482108.36256876,5695995.87814973
30,1,0,0,3,4,1512651.24067524,6221111.44270862
22,1,2,0,2,5,1868809.79314517,3862373.47732579
29,3,3,0,0,6,1754670.22964268,3735860.42038053
19,5,1,1,0,7,1426709.69917753,3501742.89841166
33,6,1,0,4,11,2283521.03576745,9909565.58893452
40,3,1,1,6,11,2409197.72840508,8027830.50528673
10,3,1,2,1,7,1940882.86478274,5539475.06953748
29,4,3,1,5,13,2551433.00925894,8211600.83295676
16,0,0,2,0,2,1288527.52718255,4273879.66516524
28,0,0,1,3,4,1279096.67295729,3737075.91905292
15,4,1,1,5,11,2470062.6435381,9239104.88125197
31,4,0,1,6,11,1987115.72718304,5453909.31637245
22,2,3,0,3,8,1673286.07505667,10868084.4200723
33,3,2,2,3,10,2150923.56108664,6894967.02471367
18,2,1,2,1,6,1760088.58250187,5964546.59584571
22,1,2,0,3,6,1529128.45831565,3149155.93935999
37,2,2,2,2,8,1746768.51819963,4490434.98995084
27,3,0,1,3,7,1299548.09551989,6571152.37653079
21,0,0,1,0,1,1213938.05485244,1920624.97100546
12,6,1,1,1,9,1757251.20211811,5882496.86423613
26,5,1,2,5,13,2607185.36298816,4224217.69781807
26,4,3,0,4,11,2207152.95872403,9209575.59888692
38,2,1,2,7,12,2149172.59419969,4068351.13093982
33,5,3,0,1,9,1481742.34549854,2481272.06065955
13,6,1,0,7,14,3144231.68322983,9192493.09671355
17,6,3,1,0,10,1369293.13224629,8852624.54955974
14,2,3,2,3,10,2117529.71412096,5589013.41812643
29,6,2,2,0,10,2503735.38355888,7249316.57215573
38,2,1,0,0,3,1289544.00198244,6207075.44289075
35,3,0,0,5,8,1603920.18238319,5690895.33345846
31,6,2,1,5,14,2537489.86217179,11433370.287193302
33,1,3,1,7,12,2038343.29252751,5804393.06123561
20,4,1,1,6,12,2862229.18513827,9453238.47555122
15,0,1,0,3,4,1636689.69300978,5372295.9122546
36,0,3,0,5,8,1738588.04765993,2959376.19787504
21,4,0,2,0,6,1611092.92678359,4888278.17029667
40,6,2,1,5,14,2531298.0658874,9158045.06899924
39,2,0,2,3,7,1536163.00068318,4570798.96408162
14,6,3,2,4,15,2130553.77027054,7746236.33262655
13,2,2,1,0,5,1411234.70281297,4029252.78387711
17,1,2,2,3,8,1349944.75830783,6958851.35033021
20,2,2,0,1,5,1594445.31802268,5383759.50191307
21,3,3,0,4,10,1348728.72249951,4106782.47628071
14,3,1,1,3,8,1786803.9718961003,7262115.38029654
20,2,3,0,4,9,1764499.76773661,2889049.06868944
30,1,2,1,0,4,1247775.98336308,1247775.98336308
35,3,0,1,1,5,1581130.33467668,1197007.92865922
25,4,2,0,3,9,1640230.29535553,6854893.86650233
22,2,2,2,2,8,2013207.91189328,6186990.58455587
10,3,0,1,2,6,1572222.06914808,6203362.05549788
24,1,1,0,1,3,1376427.98977238,2953508.01152758
38,6,3,1,7,17,2662324.02014088,5403399.19116754
30,5,1,1,1,8,1713019.15031433,4545548.81738774
26,2,0,2,6,10,2280184.50139854,6479365.40640065
29,1,1,1,3,6,1972158.44617918,3736717.85180878
11,1,1,1,1,4,1708690.34421167,4479951.54129159
18,4,0,1,3,8,1972358.94719977,6981563.71226513
36,0,0,2,6,8,1853497.25850209,4028318.96331946
25,5,1,1,2,9,1805220.16934995,8499900.18795399
15,6,2,0,4,12,2004622.03670679,7115251.5876578
27,1,0,0,2,3,1147275.25074644,5660658.99497101
32,0,3,2,7,12,1701168.38216492,7453283.20645264
14,2,2,2,2,8,1863998.42600193,4806006.17065043
21,4,3,2,2,11,2158962.50437232,9102461.65473916
11,5,1,0,7,13,1991997.8843195,10227045.3731481
19,2,0,0,3,5,1752793.45344931,6135895.96497492
32,2,0,2,4,8,2172261.12673593,4039316.0010622
14,5,3,2,7,17,2462892.5708042,9332975.91924474
27,4,2,0,1,7,1680224.719149,6309899.46803688
18,0,1,2,7,10,1704955.11466401,5086252.07607796
32,0,1,0,5,6,1695985.12750308,5704284.2996865
11,4,1,1,7,13,2305303.77631079,6621466.58081654
36,1,3,2,0,6,1786906.03676992,3110897.58828538
40,4,1,0,1,6,2077632.35622819,4312220.79010685
25,6,3,2,4,15,1544632.95237598,9003058.72039865
23,6,0,1,4,11,1710055.6172995002,6404927.2999835
24,0,1,0,7,8,2065700.80753711,4225918.73145251
38,3,1,2,0,6,1370934.27399588,5260539.64572576
36,6,3,1,4,14,2241507.37432259,8323202.10034519
20,2,3,2,0,7,1008071.60480829,4150760.19392455
13,0,3,1,6,10,2587797.92769383,6722175.93498425
39,2,1,2,1,6,1462325.78606516,4770073.63666
24,3,3,0,3,9,1468422.78459253,3356746.9751939
18,6,1,2,7,16,1899574.10309849,7904497.17620195
17,6,0,2,2,10,1944645.78833556,6865770.64125891
12,4,3,2,7,16,2730726.58690041,6467211.41399467
28,5,0,0,6,11,2186999.54185102,6634552.38539778
29,4,1,1,5,11,1844830.37423063,5112499.61702932
38,5,1,0,4,10,1827392.0015845,6038559.45774383
11,4,2,2,4,12,2755332.02687006,4769950.54273309
25,2,1,2,1,6,1481038.73592364,3550016.20472645
29,6,3,2,6,17,2717624.41572575,10957760.2977894
37,5,2,0,0,7,1658892.54762195,3321381.06057425
26,2,0,0,4,6,1370431.7562828,1763145.26798862
32,3,0,1,3,7,1905955.27172822,5000863.90987612
11,4,2,0,5,11,1825450.25833697,6518702.235247099
17,0,3,1,3,7,1539213.84876626,5030524.3486851
17,4,2,1,1,8,2066408.70432363,5688680.14189076
40,4,0,2,3,9,1672684.97862645,6408718.97387604
35,6,2,1,4,13,2129170.20345784,8672990.55102448
23,0,0,1,4,5,1661504.81949272,8351535.00207826
19,4,3,0,3,10,2473961.11305429,3631116.32705625
31,2,2,0,1,5,1293172.88680932,3655284.02369089
26,2,1,2,6,11,2658119.16646887,9897087.76710219
33,2,1,1,1,5,1444847.31422173,702856.4874244371
34,1,0,2,6,9,1561769.07140904,6503793.36509906
23,5,3,1,5,14,2080315.58728108,4646835.73111147
19,0,2,2,4,8,2116497.83795898,6126422.35630825
20,4,0,0,2,6,1504726.62835378,2569177.47825147
29,0,1,1,6,8,2006125.62891249,6051974.958227401
36,1,1,2,7,11,2062981.88939715,6921070.60249717
33,2,2,2,6,12,1970416.58167396,5461500.61248931
39,6,1,2,1,10,1534262.64800235,2270788.40209187
31,2,2,0,4,8,1708277.94007641,3749438.64546697
38,1,1,1,4,7,1512683.34042113,5724704.4455079
10,1,1,1,3,6,1224716.61170427,3838388.59413996
24,2,2,0,5,9,1724372.69790701,7055079.0398916
27,5,2,1,3,11,2791749.49106251,4221175.69612896
29,3,2,2,2,9,1666579.23386992,3658667.6253672997
12,2,2,0,4,8,1811905.36708854,3543509.17782923
18,2,0,0,2,4,1305346.78320069,4992185.82064426
11,6,1,1,7,15,2457543.05040479,7402168.92399041
39,6,2,1,5,14,2813997.29016997,4177570.64891172
19,4,0,2,7,13,2004999.77783095,6663240.17700562
34,3,3,2,4,12,1788454.35657406,9138391.34691615
19,6,3,1,0,10,2006622.49700563,5845899.37417788
37,1,2,2,6,11,1935326.67583618,4941791.43345743
28,4,0,0,1,5,1401696.51943587,4328638.13416896
31,6,2,2,4,14,2898988.57352406,8865582.86680248
10,5,1,1,4,11,2317010.44300997,3724329.84212282
36,2,1,2,1,6,1878349.83128992,5055469.785537
39,4,2,2,4,12,2233742.97045483,4365065.14989907
21,3,3,0,2,8,1901233.93697981,3147376.2452912005
25,6,0,0,6,12,2413899.3731395,6104849.75359451
10,4,3,0,0,7,1829961.82813442,5398905.44829984
13,0,0,2,4,6,1798617.8735218998,4694124.57036556
21,2,1,1,6,10,2206813.41688909,4167901.11427281
11,4,2,1,0,7,1509923.49725474,5948602.29654207
17,1,3,2,7,13,2349656.32335071,7001125.86446435
39,5,1,0,0,6,1126745.85957474,6954167.28102413
28,2,0,2,5,9,2082021.17802855,7931662.16982979
24,3,1,0,7,11,1824162.74810225,8556605.1367502
35,1,1,1,4,7,1711321.60331467,6235102.31494403
39,0,0,1,4,5,1635447.10496813,5365883.55829948
22,1,1,2,6,10,2183925.44030175,4662917.07303022
14,0,2,0,2,4,1441875.58334502,2068046.82650813
20,0,3,0,1,4,1544601.54442491,3393176.24927334
38,5,3,2,1,11,2084211.89068072,4929325.80866592
28,6,3,2,4,15,2605697.1856353,4979794.01372744
33,3,1,2,7,13,2355742.41536387,8489894.77514348
39,0,1,0,2,3,1247812.86962212,6205360.89285381
11,4,3,1,7,15,2010720.05277869,5420059.43285445
22,3,3,1,1,8,1603481.40221097,2714293.17612048
19,3,3,0,4,10,1659207.40708816,6301809.86887641
12,0,1,1,0,2,1042192.52331982,2824871.03158739
12,6,2,2,0,10,2497943.96319879,6420632.953300401
13,0,0,2,2,4,926344.2821091041,3342957.06728278
10,2,3,1,4,10,1807430.45543327,8743555.24016539
36,0,2,2,7,11,2124153.89280226,6737480.45878833
15,0,1,1,3,5,1461187.45871778,8171317.12259693
22,4,1,2,1,8,1924469.10193932,3851766.67372627
24,2,3,0,3,8,1798617.81783723,5621690.81300504
17,0,1,1,3,5,1521083.33677212,6220706.19889736
27,5,1,2,0,8,1701209.91169022,4388087.01229967
24,5,2,2,4,13,2985990.1664271,8316867.00611432
23,5,0,1,7,13,2365628.11927191,2028752.25789713
31,3,0,2,1,6,1945152.7798659,3005767.36277618
31,3,0,1,2,6,1729268.01666408,3385317.08524532
28,6,1,2,1,10,1724102.05061555,6826467.1356441
12,0,1,0,3,4,1142368.89941793,5093270.83244096
34,0,2,1,6,9,2122887.03337074,7229055.06870498
29,3,0,1,3,7,1891995.67254965,4204098.34889445
31,2,2,2,6,12,2661552.42377384,5093198.18334698
30,6,1,0,5,12,2695055.87853729,5106813.03612864
19,0,1,2,3,6,1630798.46707869,4635705.28992968
17,0,1,0,2,3,1063511.3101402,4410953.52784903
31,1,1,0,0,2,1406825.73398327,3858716.94169433
32,6,1,1,2,10,2073680.35190562,4909438.61231379
13,2,3,2,0,7,1516059.02894723,5850506.4786314005
22,1,1,1,7,10,2165501.57030146,3949114.65330413
19,6,3,1,0,10,1711359.36635326,2507033.29727364
37,0,2,0,3,5,1332634.54534819,7133610.49270105
24,2,1,2,4,9,1734800.12495567,5043323.11034403
19,1,3,0,1,5,1392148.6764071002,7545650.720541099
33,5,1,1,0,7,1526254.58480487,2822433.86869189
17,6,0,0,6,12,2108552.24289863,6612719.55881296
21,6,3,2,3,14,2141278.3326919996,7899749.51207001
18,5,0,0,7,12,2502449.18194298,6347617.57725256
18,5,3,2,2,12,2438186.32654067,8825967.11041873
38,0,0,0,4,4,1442336.21181116,4922243.65202206
29,2,3,0,7,12,1840512.2698483998,4215187.22617636
16,3,0,1,4,8,1591763.18159565,3296206.73642144
39,5,0,0,5,10,1866370.73853658,6208388.27541015
34,5,3,1,6,15,2265806.81077098,5727077.71017726
36,0,0,1,3,4,1147874.31372329,6732665.9112688
25,3,2,0,3,8,1544270.25424928,4081450.18129493
38,3,2,2,6,13,2492590.43017649,4290617.8253035005
32,0,2,1,6,9,1989246.39351924,7537953.95990017
15,1,2,2,5,10,1905831.30762983,6029923.25375521
21,2,2,0,7,11,2658480.91381613,4119398.38824361
23,0,1,2,6,9,1683977.19074477,5137927.14983636
11,2,3,1,1,7,1326718.09981848,4483950.43208004
22,3,1,2,7,13,2523810.69690101,7375959.45635782
36,5,0,0,2,7,1473187.09530735,4150744.56926021
40,2,2,2,6,12,2126716.82989657,5929426.66088189
12,1,3,0,4,8,1645903.5654396003,4345914.63191
27,1,3,2,2,8,2122767.50374283,6169597.41977901
17,5,1,0,7,13,2426197.63093429,5279247.08631361
12,1,1,2,2,6,1897913.60405958,3404349.94919513
12,6,1,1,7,15,2472455.61482907,3990400.83390728
17,4,1,0,7,12,2125111.70176297,4954061.43097582
35,4,0,0,4,8,1926256.19260616,6118530.53753107
13,5,0,1,2,8,1938300.13685822,4730081.80762153
19,3,1,0,2,6,1341633.5906272,6379987.19859681
10,4,2,0,0,6,1724181.19865364,4655261.71515723
33,6,2,1,2,11,1979032.85735949,6455405.789804099
32,2,2,2,5,11,1988786.03120104,5327539.48616761
10,2,3,0,7,12,2071299.76315699,5947574.71346258
18,4,2,2,2,10,1795708.94360413,8323512.996046001
37,2,1,0,0,3,1322139.79656224,5791579.941514
17,2,2,1,5,10,2084447.72912662,4390997.74222554
21,1,0,2,0,3,1408256.68034537,4016007.67198089
11,1,2,2,6,11,2070427.87118545,4578366.68844333
10,5,0,2,0,7,1375075.80840984,4260281.2803224
24,3,1,1,0,5,1712225.24392619,5541531.09497807
22,2,3,2,7,14,1798608.29300787,7462469.4359148
32,3,1,1,7,12,2079342.08945641,8647444.87868055
13,1,0,0,2,3,1267299.48405244,4457318.30310045
33,2,3,0,6,11,2238671.9916358,5311052.82439024
28,3,2,2,4,11,2340336.1134821,9441073.25837933
28,2,0,1,5,8,1672596.25457579,4579996.35530928
23,0,3,0,3,6,1494121.63666908,5240306.95889996
10,5,0,2,0,7,1412499.61446917,3932722.47018629
21,2,3,0,4,9,1328110.3771481002,5540813.64166545
19,2,2,0,6,10,1680273.89728685,5999050.69715688
10,2,1,0,1,4,1290984.11925559,2524501.40257595
10,0,2,1,7,10,1723429.16119048,6442369.54779903
30,6,0,1,1,8,1688496.7691161998,5726971.12899008
38,3,0,0,5,8,1586987.72255693,8062926.30118465
39,0,0,2,6,8,2003537.54117224,5818686.46030967
38,5,1,1,1,8,1852873.1930751998,4514985.18778493
21,2,3,1,0,6,1760776.39149242,6596315.41904234
35,4,0,1,0,5,1467200.87995608,7738105.56739284
35,3,3,1,3,10,2346269.80730166,5595446.39075672
34,4,1,0,1,6,1489911.85408448,6615434.05588381
10,0,3,2,7,12,1975291.38187467,6285212.82401249
35,2,1,1,2,6,1268596.35095548,5070201.25546549
28,6,1,2,3,12,2490486.87448954,6221906.38851262
17,1,2,0,6,9,1996852.70889138,7093926.60939819
40,5,0,1,3,9,1785436.16582274,4493691.74984254
25,2,0,1,5,8,1717398.71290261,6389232.07823163
37,0,1,0,2,3,1112685.57120151,3671203.92518054
39,0,3,2,1,6,1264783.48531943,6712720.77884475
33,4,2,0,6,12,2638168.65646158,228788.59100119397
39,5,0,2,3,10,2094940.16569847,5155476.25726932
16,4,2,0,4,10,2181924.9283823003,4633390.09192718
32,2,2,1,0,5,1850176.03185511,4573003.93880162
17,4,1,0,3,8,2147801.5315094,5966331.42381819
34,2,0,2,7,11,2055728.94049769,7364106.645123599
10,6,1,0,7,14,1500053.40061545,7136939.57839313
26,1,1,1,3,6,1877150.2799933997,3795861.52818243
28,2,1,0,4,7,2075476.76900416,6703341.19684073
14,2,2,2,3,9,1512813.6747969,6741864.57372818
39,1,2,0,3,6,1643861.81887331,7881820.81491588
15,3,3,2,7,15,2807487.50337426,6783895.11975875
23,6,1,0,2,9,1781422.61910465,7893483.47661522
33,3,3,0,4,10,2307215.48081147,7544405.449022
10,0,1,0,0,1,776508.906315645,3526931.00867216
28,2,2,2,6,12,2384706.23719979,9771533.3225467
26,5,1,0,3,9,1976396.62356839,4488364.19457356
10,6,0,2,7,15,2373378.29871942,9392474.5745108
19,3,1,1,1,6,1604904.54629074,4319245.63980837
27,5,2,0,6,13,2951259.82930379,8701297.82630378
26,6,1,1,6,14,2627112.49798154,8092822.95577996
13,0,1,2,4,7,1825210.60817336,8550046.76472038
40,6,1,0,2,9,1866856.94676648,6759098.49740167
37,0,2,0,1,3,1466956.49804795,6897613.25114418
40,3,3,0,7,13,2313279.35889364,8040455.48345686
16,2,2,0,7,11,2372304.63852428,6433957.16608736
26,5,2,0,2,9,1562445.46695853,7625540.11794243
33,6,1,0,5,12,2601903.40383687,8637355.26844555
13,5,2,1,1,9,2042078.29797899,8236794.75930316
37,4,0,0,2,6,1909342.56873744,3523706.18475658
18,2,2,1,0,5,1669018.66989705,7050590.06928088
39,0,3,2,7,12,2187700.17865178,7125919.88871534
15,1,0,2,6,9,2136352.0453268,6097647.02540153
37,3,0,0,0,3,1769050.34119845,2731448.12873936
20,3,1,0,5,9,2109408.47818822,5227203.60229874
12,3,3,1,0,7,1193795.72402493,3338925.64540424
20,6,1,2,3,12,1749544.23561826,8570890.61648066
20,3,3,0,5,11,2761692.11664964,8581997.57653388
20,4,1,2,6,13,2234907.29944371,8825426.25957437
36,2,1,2,1,6,1512086.03609916,5885495.00713303
17,6,3,2,2,13,2275331.59951773,7604041.09704677
40,1,1,2,7,11,2064300.91432269,6748786.04504271
31,6,2,0,0,8,1575727.89133196,2519674.99324095
16,5,2,0,7,14,1780401.42280566,9946069.51199878
21,3,2,1,1,7,1609590.8870148999,5288681.33262936
27,6,0,1,2,9,2065565.83217483,2829505.46610702
19,3,2,1,0,6,1953006.63607973,3419268.9210382
27,6,2,1,3,12,2549926.31282306,5909193.93272783
20,4,2,1,4,11,1849235.37112406,4796998.45274081
35,1,0,1,0,2,1367502.95927959,2570399.71096476
37,3,1,2,2,8,1742575.90302586,5216625.43103452
35,3,1,1,4,9,1547866.40160104,5740480.31626665
15,2,0,0,1,3,898549.7520175709,4762411.3523822
28,3,0,2,6,11,1789390.57927389,3274710.79132274
37,4,3,1,6,14,2252545.97468187,5572999.67319423
18,4,1,0,3,8,1147669.07261307,2952995.75965912
24,1,1,2,1,5,1526935.80199289,4635340.02626619
11,3,0,2,5,10,2348614.98251907,5659033.08804214
39,6,3,2,4,15,2574445.23502245,5739137.41514616
37,0,2,1,2,5,1302403.30228744,5122641.56721626
31,6,1,2,0,9,1420256.07825693,6053289.18429007
18,4,3,0,6,13,2626140.77277005,5786737.5214515
31,4,3,2,0,9,1815845.67605376,4766300.89744765
21,2,3,0,5,10,2177681.03771154,4700001.99881432
10,1,0,2,4,7,1703978.68663182,3915882.633767
24,6,2,1,6,15,2824923.53423365,7962174.03385614
39,6,0,1,2,9,1790811.56695419,5549184.78017985
26,1,0,0,5,6,1498931.0396895001,4671073.2663512
30,5,0,0,2,7,1778921.09156057,5168469.4848363
35,6,0,2,2,10,1853644.94628922,9371074.00671946
35,2,2,1,7,12,1915301.50912464,6064346.52040051
34,3,2,0,1,6,1981550.39349553,4699546.85677391
20,2,0,2,4,8,2192071.33011761,5899508.17272272
13,0,2,1,3,6,1469933.17126919,8279092.19574032
39,6,1,2,1,10,2144795.72009626,8378476.24705221
11,5,1,0,2,8,1490599.96770219,6183720.95962829
25,4,1,1,7,13,1925181.06590898,4040572.60062369
36,1,2,1,5,9,1520463.19352783,2990388.27384577
11,4,1,0,7,12,1126833.20489039,3797608.25301565
34,3,3,2,4,12,1780847.51587007,6839655.14644572
12,6,2,2,0,10,1990723.64233812,8723544.50757726
40,4,0,0,6,10,2077413.48837006,5019730.36991482
16,0,1,2,4,7,1643266.71647349,5586920.30716971
33,3,1,0,7,11,1454137.58829878,9475520.98504628
27,5,3,1,5,14,2215585.25898472,8566170.5897765
17,6,1,2,1,10,2002309.0870766002,3285432.2023711004
19,6,3,0,7,16,2796387.32205689,6726823.0070569
10,4,3,2,2,11,2090505.47565279,7922392.64946938
17,2,1,2,6,11,2341143.80695991,6279997.93233233
29,6,3,1,2,12,2537237.16263262,6469707.60801035
25,6,1,1,1,9,1570322.11448478,9211877.11834924
24,3,3,2,7,15,2540247.31534161,6580270.00834647
13,5,3,2,3,13,2486622.18002985,6695090.28940772
27,0,2,1,7,10,2383772.03154845,7998379.48588016
26,6,1,2,2,11,2411746.42064059,5658655.29367029
15,2,0,2,0,4,1323094.35812655,4865111.59967986
33,2,1,2,4,9,1961983.08403205,9331632.35341318
35,2,0,2,1,5,1414230.27589997,2878158.97159443
17,3,1,0,6,10,1087980.67654003,6962170.45510972
25,2,0,2,1,5,1383064.83139842,5537995.69163637
15,6,0,2,7,15,2615106.93854344,4394920.62503781
26,3,3,1,2,9,2353844.29974121,3818095.81974017
37,4,0,0,4,8,1601122.90675209,7250611.79143542
33,5,1,2,7,15,2082390.15322084,5686775.07050276
20,5,0,2,5,12,2059000.33286997,6279781.35993653
31,6,1,1,4,12,2546588.8220233996,6917423.10974229
24,5,2,2,2,11,2180444.48776468,5390914.94996177
25,6,2,1,4,13,2233035.7760202005,8572120.28895499
38,6,2,0,3,11,1820927.55700542,9477004.77800686
28,6,1,1,5,13,2060463.97385737,8201340.36166687
28,4,3,2,5,14,2086327.60779831,8066283.27713821
40,5,1,2,3,11,1475305.11312374,5456910.50049983
39,0,2,0,1,3,1443012.33531607,3185590.76370886
39,1,1,2,3,7,1777301.91028524,9000106.42599335
25,2,0,0,0,2,1151259.03892807,4078286.7306495
39,2,1,1,6,10,1983339.03300871,3498999.62898005
27,1,2,0,6,9,2130273.73493742,5233866.3378167
21,0,1,1,6,8,1234564.70142854,8962151.40910557
23,0,3,0,1,4,849476.0658381879,3882229.76079193
30,5,2,2,4,13,2218475.62644033,6379806.33779706
11,5,0,1,1,7,1869033.11604899,4647987.16258102
32,5,3,1,0,9,2203273.05535036,6657547.99057659
10,6,3,1,4,14,1979598.26626496,8410453.32697391
23,5,2,0,1,8,1764056.13066068,3676608.78596605
38,6,3,1,6,16,2564699.75080287,8020685.88503671
31,5,2,0,2,9,1632612.36512389,5385521.39445614
39,5,1,0,3,9,2171812.44037903,3690354.28650618
14,1,3,2,5,11,2284089.89398293,7925126.50125153
24,0,0,2,2,4,1271130.62766542,2255746.10190422
17,0,2,2,1,5,1214177.68263293,2377982.04166762
13,3,3,2,1,9,1933368.7459807,7048740.00699456
17,1,3,2,7,13,1796702.25773375,3735086.16486342
37,6,3,1,6,16,2415093.08309061,9838158.10525094
11,5,3,1,0,9,1977356.87732332,9802126.17684378
24,0,2,0,7,9,2211997.71053423,5459023.82444865
20,2,2,1,1,6,1559372.65827917,4095540.7348001
33,3,1,2,0,6,1817541.66676933,4394892.62865616
36,1,1,2,6,10,1782743.39567993,9507253.11308988
10,6,1,0,3,10,1971452.20619945,4291208.47872676
34,0,3,1,5,9,1299880.65975375,5634693.80380502
16,4,0,0,4,8,1454294.94691201,3795607.3574806
40,3,1,1,3,8,2048684.68052254,7523981.70096546
24,2,3,0,6,11,1945454.6367481002,5217481.82870761
34,0,1,0,4,5,1395358.00170697,4270229.06813764
31,4,0,0,3,7,1319689.29687688,4040535.79982987
27,3,3,1,4,11,2319041.39637252,4087489.5967259
14,1,2,2,5,10,1618432.87264274,5712814.52153972
30,2,3,2,4,11,2202944.2658892004,4175131.36785163
20,1,1,2,6,10,1771329.75001436,3803167.95484547
17,0,1,2,3,6,1235125.88009217,6032151.52665274
34,4,0,0,7,11,2364584.13693063,3980851.79622365
36,5,0,2,6,13,2383815.71959991,2561449.61466861
13,6,2,1,2,11,2330233.36619668,8758152.70757432
31,6,0,0,1,7,1663849.70598922,4834193.34836171
39,2,2,0,3,7,2003411.92324163,7431691.4509719005
35,6,3,2,6,17,2895832.2169363,10361925.3735149
15,5,0,0,7,12,2286392.15315009,9530469.82562857
19,6,1,0,1,8,1991613.00522614,5156459.85265226
23,3,3,1,3,10,1859113.9224339002,8251203.23896207
34,4,0,2,3,9,2112954.49814387,6493999.19852262
18,1,0,0,3,4,1713955.09619333,3977030.10007276
11,6,0,0,2,8,1721685.26183428,6114409.36651692
27,4,1,0,4,9,2114017.50527921,6442426.69183323
19,6,3,0,2,11,2000508.79686466,4348476.59634378
38,4,1,1,6,12,2342865.88417398,8094594.57631604
25,0,0,2,4,6,1400720.27256649,7830993.44011734
15,1,2,2,2,7,1417873.25593443,5595046.6298001995
27,0,3,2,2,7,2086892.00388982,7385747.84977861
38,6,2,0,0,8,1684592.04991467,5187189.66037998
20,1,3,1,3,8,1570653.92167474,2924581.02760944
35,5,1,0,0,6,2099409.28490409,4936766.95757899
26,6,1,2,0,9,1949829.25547784,6573673.75236518
17,3,0,2,4,9,1712466.72271794,5898753.1836842
30,6,3,2,2,13,2043694.03920646,6578375.31680923
18,3,0,1,6,10,2180063.98799568,6755285.77045511
16,6,2,1,0,9,2130385.23933871,4745314.75259279
33,1,3,1,2,7,1752713.83154208,6921799.55601466
14,6,0,2,4,12,2180988.62514578,7466469.18294153
28,4,1,2,0,7,1547418.89276969,5463140.26618224
39,6,2,0,0,8,1870184.16736443,4694361.42642319
32,3,1,0,6,10,2632166.82400407,3573509.98423285
38,0,3,2,7,12,3075843.92823212,4305349.65549232
37,2,3,2,1,8,1844836.12445384,4392575.46223303
17,6,0,0,5,11,2145094.35884506,7229393.55569236
40,3,1,1,2,7,1928497.57641415,1980536.4010102001
35,5,3,0,5,13,2077905.64559335,8708365.78862024
30,5,0,1,6,12,2617836.79046479,5557405.63897003
13,3,3,1,6,13,2164814.01691239,3815040.68334538
18,0,3,1,6,10,1717407.30796425,4159180.77762201
27,5,2,1,7,15,2742581.60895628,7206232.52131822
36,3,1,0,7,11,2629470.31415924,3258274.54933946
35,6,2,2,0,10,1921454.02459587,7338940.93456909
37,2,1,2,2,7,1579964.85633831,6299164.32519594
36,1,0,2,2,5,1540353.92178282,5502309.12441098
21,5,3,0,3,11,1587251.22889638,10606647.726743
32,6,2,1,7,16,3460869.76926862,8802487.33143776
11,4,1,0,1,6,1654975.55439248,5003485.20101787
14,6,0,1,3,10,2089008.29644455,6657334.2147076
18,5,2,2,2,11,2267375.90202568,6481891.87527457
16,4,1,0,3,8,1922135.30451406,4394935.47500326
34,1,2,0,5,8,1784338.85879015,6773578.94055935
18,3,1,2,3,9,1778679.74066647,4921964.80065594
23,5,1,0,4,10,2056900.87274625,5428322.85585573
38,2,3,1,2,8,2018903.37132058,6787690.63461723
24,6,3,0,6,15,2718602.11633425,5598279.06434253
35,3,3,0,7,13,2972140.34508854,4648327.57163866
16,6,1,0,2,9,1329791.43218233,5663472.91395062
23,6,3,0,4,13,2983241.68623084,11203386.143578999
16,5,3,2,4,14,1993547.0645675,8171398.99584152
39,2,2,1,6,11,1806978.8572987,5576828.13368888
40,1,1,1,4,7,1729308.75390563,4040856.73280282
29,4,2,1,6,13,3155382.6268137996,5351750.66401405
40,0,1,0,7,8,1524917.13746403,2187177.73928825
21,3,2,1,5,11,2643145.15562356,6903901.26366173
13,2,2,0,3,7,1797013.88942203,4987944.27660169
11,4,0,2,7,13,2935011.2292907997,5543548.7738927
13,1,1,0,2,4,1495532.16584941,2466707.12974176
35,2,3,0,0,5,1871867.45204128,3849328.98244797
15,6,2,2,7,17,2992200.72429952,6655933.48672482
31,6,2,0,4,12,1815361.01165803,9296770.92506891
34,5,3,1,2,11,2048979.03862392,9180106.61670098
27,3,0,2,6,11,1610755.84777298,7616211.19928227
21,5,1,0,0,6,1505590.07237901,4599702.77376051
21,0,1,1,4,6,2005786.49248803,7332448.50707822
23,2,0,2,6,10,2073683.98799248,5403390.97578598
32,5,2,2,2,11,1795680.86839146,11050380.4184452
25,5,2,1,5,13,2304308.89714275,7533784.93800171
30,6,3,2,6,17,2542525.7481172998,7438720.91525671
34,1,3,1,0,5,1304898.97177219,5133974.47613757
31,2,3,0,5,10,1591531.31268868,6127220.90539565
13,1,2,2,7,12,2384664.78266253,4419902.52455923
28,1,3,2,0,6,1661272.25645658,3963468.6451495
12,4,1,2,4,11,2650102.18046054,3581972.57601803
40,1,2,2,3,8,2078438.78312525,6443963.92992357
33,0,3,2,1,6,1780412.60620198,2426569.47481055
35,2,3,2,7,14,2194700.61182073,6621758.315438501
26,6,2,0,1,9,2162335.30573991,7643083.91674903
18,6,2,0,5,13,1701369.92641104,8767380.71508939
13,2,0,2,4,8,1803513.07159844,6830510.6139883
25,5,0,0,0,5,1676865.79674762,3754581.9731291
17,3,0,2,1,6,1464842.17914329,1710985.68197674
12,5,0,1,7,13,2417767.03130601,9394070.205393
19,3,2,1,5,11,2453580.68895567,4071609.00456721
12,3,3,2,2,10,2335888.91665581,10170522.9891524
10,5,0,1,0,6,1510912.08938324,2446148.07577545
30,6,0,0,0,6,1470109.12056272,1051900.68315289
18,5,2,0,6,13,2404895.28021303,6823463.46187625
21,6,0,0,3,9,2074208.57504356,3605035.25897307
18,6,2,1,5,14,2323197.78661648,5962251.20607682
14,1,1,1,0,3,1274529.05675728,3779960.23139528
37,5,1,1,3,10,1643207.40522463,7292522.71885048
33,5,0,1,2,8,1974764.88231626,8639988.60717229
24,5,2,2,6,15,2508852.78392766,5006895.31478592
34,5,2,0,2,9,1831099.09827123,6012168.91838462
36,0,3,2,1,6,1682547.22906068,5420971.61803744
28,1,3,0,6,10,1602966.70430534,2285098.95248707
36,6,3,0,4,13,2012179.98221161,10902085.895399401
13,1,0,1,0,2,1251291.10280856,2092570.56251658
28,2,0,1,6,9,1660057.71077752,5282926.23485941
22,5,2,0,6,13,2824074.83191538,5508944.04244459
19,2,2,1,5,10,1826052.41637708,5217133.95183568
10,2,3,0,3,8,1876176.54261148,4054879.90594009
11,3,0,1,7,11,2228661.33210197,7282534.830557599
16,5,1,2,4,12,1652173.77436524,3130016.82847764
26,2,0,2,3,7,2103646.68748092,3860365.25841174
22,6,0,1,0,7,2282061.01490844,7271249.788219299
32,3,3,2,0,8,1615568.61069064,5535546.2452477
25,2,2,1,6,11,1966065.02996558,6495614.80527376
22,3,0,1,5,9,1601560.49509274,2613900.54213031
36,6,2,0,3,11,2472363.44992237,5093343.2005178
11,0,2,1,5,8,1747554.08822323,5831961.06663404
27,3,3,0,7,13,3167731.5701119998,4391601.36898168
12,0,3,1,3,7,1687759.83739327,6897349.11088525
25,0,3,0,1,4,1182502.66945197,5177719.11769339
35,3,0,2,3,8,1338825.54949215,4643397.06921464
34,5,1,0,1,7,1279854.74347762,4114467.23849997
12,0,3,2,5,10,2142605.74100589,2841450.06194803
34,5,1,1,3,10,2147879.82848616,9643720.95929934
30,2,3,1,2,8,1691607.68959702,5017292.75292679
39,5,3,2,4,14,2111319.62894489,6632366.59275237
10,3,2,0,0,5,2264932.08267554,2549428.5702799
35,4,1,2,4,11,2270636.46255915,6275243.28568471
14,0,2,0,7,9,1233567.97223867,6588759.18306848
33,6,3,2,1,12,2239646.40158208,9718932.20291617
26,1,3,0,2,6,1771292.64975089,7197189.7472815
29,0,3,2,5,10,1846898.2472001999,6829426.21412103
11,4,3,2,0,9,1555634.37531899,5876257.56405268
22,2,3,0,4,9,2393416.42940331,4028886.52742229
10,5,3,2,0,10,2055162.3429119,2822071.99869259
23,1,1,0,1,3,922812.5976079521,3022727.33589227
35,4,0,1,5,10,2129119.5674711,3488140.64227728
13,0,2,2,5,9,1599625.71539417,7266419.76202043
12,1,0,1,5,7,1638422.40450915,5104171.41905806
24,0,0,0,4,4,1237950.62670427,2673438.85101175
29,0,3,1,7,11,1598604.60929838,4968288.92959356
39,6,0,1,4,11,1876361.13613847,5678979.438071599
37,2,2,1,2,7,1338505.80612145,3541255.45083848
19,5,3,1,7,16,1975670.17219518,13339004.999303501
20,5,2,2,1,10,2111181.30268811,7388188.65180284
23,0,1,2,7,10,1454072.57136739,3650342.39836169
15,2,3,0,6,11,1532908.81562503,4250984.87777338
25,6,3,0,5,14,1905051.98982077,4732928.44047455
38,4,0,2,2,8,1751456.66555556,6768655.31949579
35,1,0,2,0,3,1289187.5016808,3857740.70097907
17,3,3,2,2,10,2390332.73655537,7044784.13423946
26,1,2,1,3,7,1799710.17952866,4562467.02412546
12,4,2,1,6,13,1814893.74676861,4921150.00425185
15,2,0,2,5,9,1581237.50904209,4788056.37200254
22,4,0,0,2,6,1341476.78360524,5234663.95107737
35,2,1,2,2,7,1266776.11565816,5817627.15434153
11,6,2,1,3,12,1766969.53934158,8933416.20050953
15,5,1,2,0,8,2196255.79389091,5879014.50603136
32,2,2,0,5,9,1594110.18150077,9231867.48234749
20,6,2,0,3,11,1865522.47631814,5926743.99264714
40,5,2,0,5,12,2247723.54384516,6252509.26184043
14,0,1,1,1,3,1302911.05189064,3036863.22204127
13,6,1,1,3,11,1920022.83650197,9431739.97785096
29,6,3,1,6,16,2442370.8316679,10871364.443902198
28,5,3,0,0,8,1796873.68657245,3417617.11099649
27,3,3,2,5,13,2167633.03868494,10379728.2752368
37,2,1,2,5,10,2344773.28406679,5503216.47870724
26,6,0,2,2,10,1763198.13044053,8562557.63597232
16,4,3,1,2,10,1735870.45439718,6917870.65518476
11,4,3,1,2,10,1327794.43954017,3867171.73992011
25,3,1,2,7,13,2051247.20624047,7302672.13741623
38,1,3,1,0,5,1956918.30153868,4155290.44257086
23,6,3,1,2,12,2347133.85774142,5476036.40826986
31,4,1,2,7,14,1673231.17236136,6298361.60219097
38,4,2,1,7,14,2404568.92119853,4854709.14837421
26,5,1,1,2,9,1297296.24109522,8238096.94683088
22,5,1,2,2,10,1672614.39367777,5289027.97368499
18,4,1,0,4,9,1930651.03076537,5681104.60828832
17,0,2,2,6,10,1664654.21548778,5402610.23935756
39,3,0,1,2,6,1552141.96472468,5933910.70153722
14,0,2,0,1,3,1561126.24191581,3142323.88918691
39,5,2,1,4,12,2390008.08536062,7585829.85578674
25,6,1,2,4,13,2139928.58291225,7212768.36608764
32,1,2,2,5,10,2292293.52176047,6365055.2292706
33,2,1,1,6,10,1847961.15591508,5957472.35082121
29,0,2,2,1,5,1290258.20954756,1857193.50691056
30,4,2,2,2,10,1726014.29135023,8400883.97850439
17,6,3,0,1,10,1526694.78147859,5672786.44783097
20,6,3,0,4,13,3025396.07883445,6636568.09717817
25,5,0,0,7,12,2367502.07535699,5638581.61362616
39,0,1,2,3,6,1112072.12073112,3653732.14231715
24,3,2,0,0,5,1487700.49422658,3748449.3858756004
19,5,3,1,7,16,3361937.18940993,10080612.3087551
39,3,3,2,0,8,1932889.45499677,2305278.60426592
40,2,2,0,2,6,1621981.76555355,7883050.21938026
31,5,2,2,1,10,2683840.62319509,7543054.3437039
18,5,2,2,3,12,1878769.07088419,9075792.9923649
34,0,3,2,6,11,1931614.13137804,8169084.64385569
25,1,1,0,5,7,1576722.25744964,4489712.89117253
35,5,1,0,3,9,1676894.39275226,8829221.38304364
11,3,0,1,4,8,1347542.36812051,7340260.07087697
38,3,1,1,7,12,2214809.0682177003,6382549.86273079
25,2,2,0,4,8,2046560.18876377,4152250.54315623
37,4,1,1,0,6,1980128.15637768,4276901.1156457
25,1,3,1,0,5,1675381.12519838,2503313.5967544997
20,3,1,0,2,6,1685167.77872707,707793.727686578
16,1,3,1,3,8,1850251.61563096,4773283.04991647
28,3,0,0,2,5,1806351.35235817,3698898.63300662
10,3,2,2,4,11,2201471.52557733,8024250.04501721
13,1,3,1,6,11,2689191.5019499,7191279.06797941
19,3,2,1,7,13,1649279.12090324,8232707.49621744
36,6,0,0,6,12,2016590.42757619,5419957.96230372
32,6,1,1,1,9,1750876.26282909,7106221.85331423
26,0,2,1,2,5,1241417.43474358,4097888.82108759
13,4,2,1,5,12,2279803.44265842,7249271.70087302
15,4,3,0,5,12,2281760.61534819,8286238.69945382
13,4,1,0,5,10,1891096.64279899,5213977.14681745
33,4,3,2,4,13,2779526.48441945,4623016.96501939
24,2,2,2,7,13,2387918.93386857,5714045.24084298
24,6,1,0,6,13,1931701.68396572,4521652.17751344
16,1,2,1,1,5,1202645.82690592,4011866.54776666
17,4,2,2,3,11,1994499.02212466,7790288.70238542
30,4,0,0,3,7,2130981.32021821,4512929.09405814
22,3,0,0,6,9,2063981.77979396,3916303.29719933
15,4,1,1,4,10,1740036.73501316,4068219.35921465
34,1,2,2,5,10,1893286.42844125,7597964.27958739
23,3,3,1,0,7,1612233.58140162,2969488.90018666
28,5,0,2,5,12,2753178.59024749,8228711.58487321
25,1,0,1,7,9,2013569.35829861,3671750.89929129
14,0,2,0,1,3,1219794.09046553,4449540.87168773
16,5,3,1,2,11,2572007.17851231,5137829.02274281
23,1,3,0,5,9,1982868.34561161,8860642.26022286
16,5,0,0,7,12,2094300.14302553,6832624.63686498
36,4,1,1,2,8,1550180.4763748,4077620.1965948995
18,5,0,0,1,6,1615057.1680278,3932285.64549519
38,5,0,2,6,13,2984056.03342749,3010138.12415017
27,5,1,0,1,7,1407855.91855078,7892715.67021122
21,0,1,1,1,3,1308923.75823273,3909094.20599604
12,0,3,1,0,4,1042221.36921468,4644483.31729676
22,3,1,1,5,10,1987891.41613127,5936423.45722914
29,5,0,0,4,9,2218653.32068932,1328723.36225748
37,1,1,1,3,6,1638687.07962244,409040.98148624203
37,1,3,1,0,5,1308316.284959,4746924.64737162
24,1,3,1,1,6,1405690.8782347,4398688.68133687
16,0,3,2,7,12,2409747.21645216,8293169.91359047
16,5,0,0,3,8,1913127.99206944,4694695.88138293
14,4,1,2,4,11,2345809.88895848,8646212.11640892
29,6,2,0,6,14,2729279.31796771,9493934.03233869
29,1,3,0,1,5,1538862.6689316002,3654379.72453985
11,3,3,2,5,13,1826109.47444768,7713470.38917462
24,5,1,1,4,11,1763496.32269738,8530622.0282538
27,5,0,2,6,13,1938440.10864415,8657585.91929827
11,3,0,2,7,12,2005249.54015982,8471040.00646287
21,2,3,2,0,7,1435587.20886415,2920197.69754586
39,5,2,2,2,11,1616419.44636605,8879458.56473956
34,0,0,1,2,3,959813.589429505,5838364.32182597
34,2,3,1,1,7,2277999.04381461,1744288.67515001
14,0,3,1,5,9,2057668.0818538999,4433342.22105179
21,1,0,2,7,10,2022060.50920929,6461779.79280872
28,6,0,2,4,12,2181542.7326535,9401597.83731326
15,5,1,0,2,8,2248205.84882543,10231754.830833802
38,0,0,2,4,6,2010738.59791034,5204043.99111684
15,1,0,2,7,10,1602045.14159143,8040556.38982296
17,2,0,1,6,9,1773951.09770425,3007026.78014424
12,5,1,1,6,13,1717205.86207714,7798475.61298515
33,2,3,0,1,6,1256316.99953031,5033687.93672615
18,2,1,2,2,7,2148819.49159249,3144087.00160865
36,0,0,2,5,7,2144615.77575436,3284452.08827516
22,3,3,1,4,11,2390941.16358869,4946138.42623706
29,1,1,0,1,3,1045246.62466261,5791066.47118177
12,2,0,1,5,8,1424077.03869676,8251232.28122403
12,3,0,1,5,9,1972866.77387346,5515062.50759913
21,5,0,1,0,6,1885636.41300439,5729916.43114765
18,1,2,0,1,4,1161270.66447012,4430723.11454553
23,1,0,2,2,5,1441907.38343885,2893831.04772894
27,1,1,2,0,4,1747703.11345502,4712757.46121839
35,3,3,0,7,13,2820407.77049217,5956484.54144851
20,3,3,2,4,12,1536235.79170422,4480518.9767335
24,5,3,1,2,11,2329214.55800273,5487186.21986827
27,3,0,1,1,5,1103020.34087071,1852498.36424921
24,6,1,2,2,11,2198676.90803357,3455679.28059421
26,2,2,0,1,5,1596113.57167561,3811003.4560017996
19,6,2,1,7,16,2658807.95430773,7207818.26921529
36,4,0,1,2,7,1665331.68006244,4198225.67233913
35,2,0,2,4,8,1593719.37678734,3255527.27015109
28,4,2,0,5,11,2080681.94723711,4049195.26851671
21,1,1,2,6,10,1736970.94483264,6629530.04314664
39,1,1,0,7,9,2445858.55968533,6728417.88784453
18,5,2,2,4,13,1886510.76624603,12003000.9693877
22,3,0,0,7,10,1911039.39130301,5222719.88327962
11,6,1,0,6,13,2110878.09114133,6969444.48265605
34,0,1,1,2,4,1383883.49109567,2274434.3434389997
21,1,1,0,6,8,1500473.22606927,7734046.67647959
28,0,0,2,5,7,2414444.66462233,5727326.41836137
12,2,0,1,0,3,982401.3334678509,5063049.73986419
39,2,1,0,3,6,1723228.95320779,4133713.22341181
34,5,3,0,5,13,3090774.22203125,9302570.83465243
35,1,1,1,4,7,1966017.5764956002,7026001.38657303
25,2,1,0,6,9,1509265.70473146,8490794.24829405
31,4,3,2,1,10,2034501.49670453,6526062.32264168
23,0,0,0,2,2,941795.3472660609,5031797.06622959
30,1,0,2,7,10,2848449.34603761,9519165.72231051
33,6,0,0,1,7,1966268.09132144,9270936.01029119
39,3,0,1,4,8,2014796.04080791,5778502.29422743
38,3,3,2,7,15,2653431.08724364,8590508.93605847
37,1,2,2,1,6,1266674.12734483,2581188.79580436
37,4,2,1,5,12,2720136.90159249,7277523.09458544
31,5,1,2,1,9,1455475.47841873,8997469.91802511
19,6,1,2,4,13,1424162.47566444,4940046.23981363
11,2,3,0,0,5,1454724.73907957,6605357.20353988
37,6,3,0,5,14,2182475.34002738,5939203.75233325
34,6,3,0,6,15,2411748.56565614,4604391.70522468
18,0,1,1,3,5,1584555.50296107,5676954.32469135
20,1,3,2,1,7,1488738.96902222,7641312.22877768
25,4,0,2,4,10,1156811.00551043,6876173.80128813
10,2,0,2,4,8,2005454.5905257,5153952.11639805
16,1,3,1,1,6,1850776.71246917,1772006.76048757
10,6,0,1,2,9,1536438.61592412,7491807.96372053
20,6,0,0,1,7,1429419.6627214,6832329.6204222
34,5,2,1,1,9,2134691.11623127,7464929.51616047
36,6,1,1,7,15,2185408.17122491,7941279.1802357
31,1,2,2,4,9,2000223.20086179,7475750.40879817
22,4,1,2,1,8,1639315.82562558,7850927.87606787
22,5,1,1,3,10,2329497.82740979,6667793.33366615
38,3,2,0,2,7,1461987.50653193,5125183.57608096
16,5,2,2,2,11,2371709.68485984,2388399.49276255
17,2,1,2,3,8,2069010.83133542,5072800.07958173
17,0,0,2,6,8,2251652.48043982,7325105.83024392
32,5,3,2,0,10,1780357.4054852002,3834650.08960531
35,0,1,2,6,9,1312032.20446737,5115914.57696724
34,6,2,1,4,13,2334178.61984386,9033354.8301614
38,0,1,0,7,8,1933916.70302059,4939813.25941212
34,6,2,1,7,16,2776008.05045506,7988211.71077575
23,3,2,0,2,7,1956083.51636515,2857529.88985445
13,3,0,1,1,5,1100689.80155342,3957303.89260404
33,6,2,1,5,14,2528653.34690937,12172203.913911698
38,5,3,1,6,15,3307922.27638883,8503945.88750652
23,0,2,1,4,7,2059712.19090923,6187662.80853225
12,3,3,0,0,6,1088851.97934912,4920659.41877768
11,2,3,1,4,10,1905037.41545565,4720320.41610679
22,2,2,0,3,7,1552400.2876604,6404166.35263538
11,3,1,0,5,9,1944377.12546593,7930457.80769462
39,2,1,0,5,8,1963401.29830995,988297.4473237259
29,5,0,1,0,6,1566120.27522842,5166532.85587455
22,4,2,0,3,9,2451312.27073834,6501167.62688956
11,1,2,1,4,8,1825279.88330192,2610638.25499527
17,2,3,0,5,10,1524725.24135237,4529795.305421
36,4,3,2,2,11,1107070.48486377,6955332.27610827
19,1,0,2,7,10,1692167.99564241,5970466.29885043
30,2,0,2,7,11,2042027.2449047002,9517936.75130584
40,4,1,0,6,11,2109930.28976082,7431718.99622165
14,6,0,0,3,9,2334298.30750444,8748868.20189854
32,2,2,2,4,10,1558256.58362303,3852478.80137061
40,4,1,1,3,9,1995092.69989758,4082146.90377437
23,3,0,2,4,9,1923627.2859283,8519841.41141739
22,5,1,0,4,10,1960535.69311326,5323888.32655013
10,2,3,0,2,7,1688103.99582865,6358649.38294195
19,1,2,0,4,7,1811467.35733013,4552609.37074859
28,2,1,0,7,10,2106368.48826289,5739596.57639782
10,5,0,0,6,11,2598930.10295323,6167797.21818125
22,6,0,1,5,12,2764209.23909197,6565135.19770861
25,6,2,2,4,14,2585781.37715042,5610547.27100498
27,2,3,2,7,14,2636524.64015452,5977921.33309814
35,1,1,1,7,10,2273908.62604259,8835267.22045134
27,5,1,0,0,6,1203303.4591715,5563942.85427563
20,1,1,2,3,7,1809632.06694786,4199189.49144286
11,0,2,0,7,9,1604065.13793186,3332589.53138554
20,5,0,2,7,14,2676122.3283656,6869674.39958664
33,5,2,0,7,14,1658899.97346278,6945896.73191118
37,4,1,1,7,13,2549851.08695476,6416164.46506495
18,3,1,2,7,13,2029490.87880657,4408353.40309197
40,6,2,1,2,11,2603904.65397837,5435496.05037249
11,6,0,0,1,7,1648813.11892863,5870210.69552608
16,1,0,0,6,7,1616142.74149274,6898191.66855756
40,3,3,1,3,10,1609153.09276562,2065382.08150541
17,4,0,2,1,7,1837889.52725726,4144527.5733083
32,3,2,1,1,7,1112572.97779961,7163729.00726063
32,0,2,2,7,11,2495355.62752787,6894900.91228479
38,6,0,1,2,9,2337350.55510828,7951924.40957509
13,1,2,1,6,10,2073412.44124163,5696390.36468364
23,1,0,1,5,7,1866982.68952767,5894804.13239842
14,4,2,1,2,9,1576059.76406354,3994383.95977923
39,3,0,2,3,8,1890618.48874894,2723742.18341894
12,5,0,1,6,12,2296346.87956354,7312946.64941676
10,6,0,1,1,8,1805722.96637122,7328665.34630266
12,4,2,2,4,12,2616010.89158515,3920668.16138224
29,6,0,0,3,9,1538167.52177591,6945554.10298747
34,5,0,0,3,8,1893578.50026655,10077798.435565801
18,2,0,1,7,10,2146455.1126627,6220656.39503631
23,5,3,1,1,10,2072345.68136403,7120102.91715983
26,2,2,2,5,11,2886260.35037047,6465402.40021806
32,5,2,2,4,13,2354346.95779186,3777318.43736255
24,1,3,0,7,11,2249513.16556326,5369772.68947997
26,0,1,2,1,4,1414625.71071863,4164956.05985867
28,6,2,1,2,11,1825289.99025931,7556347.0424972
27,0,3,0,5,8,1701875.16378713,5471717.61190967
12,0,0,0,7,7,1930310.56451123,1133093.20104079
25,3,1,1,2,7,2036204.43761034,4877650.06649242
14,2,2,1,0,5,1554942.19431824,2444391.87146318
31,6,2,1,6,15,2762861.04654642,4568432.01518589
17,1,1,0,1,3,1634131.63102887,4373904.56180705
33,0,3,0,2,5,2062834.67708501,3018219.06249917
38,4,2,2,4,12,2023534.35259416,10435809.1192271
24,5,2,2,7,16,3607984.41696841,10617119.7584569
37,4,0,2,6,12,2520257.31226644,7259324.17126278
27,0,0,0,3,3,1420427.73645563,7435216.23547853
12,1,1,0,6,8,1748167.16125858,5547858.2598737
12,3,0,0,6,9,1578436.55401264,3791812.42387413
35,3,0,0,3,6,1393335.42437299,5498666.68337572
11,6,1,2,0,9,2233302.24176501,6711440.59412718
15,0,0,0,7,7,1319398.62932098,7013245.91181477
14,1,3,2,2,8,1746819.26678537,571143.527709728
22,5,1,2,0,8,1811872.01440456,6173845.72735297
24,2,1,1,5,9,1088438.78601843,5160080.97229918
11,3,2,2,0,7,1619330.51706412,8648457.65435556
38,2,0,0,7,9,1756688.45187512,6556835.76012831
21,6,3,2,2,13,1743557.8910671002,7585943.84833465
15,2,2,2,6,12,2168368.52843138,4754888.95404702
38,1,0,0,1,2,875676.3630058841,4776145.19041439
14,2,0,1,1,4,1311028.48424992,3134831.51129438
32,5,3,2,7,17,2836877.89920519,7844367.022104901
17,6,0,2,3,11,1858167.80907476,7435574.76425308
19,5,1,2,1,9,1448572.19865246,6939604.21386106
20,6,2,2,0,10,2442468.89737144,6682549.31115931
35,6,1,0,6,13,1882069.94023159,5320908.06139543
27,2,2,2,3,9,1604998.82927296,3243086.03553067
24,3,2,1,6,12,2625838.26893888,6605195.37729698
38,3,0,0,1,4,1633925.89658713,5266560.16403519
18,5,0,2,6,13,2078819.9410436,5864192.84396933
32,5,2,2,0,9,1432644.54475134,5439322.62185566
40,5,1,1,7,14,2510940.39874899,9093730.97217007
39,2,3,1,2,8,1879446.18093014,4686517.42595776
29,4,1,0,2,7,1702451.64735252,4019794.75687967
20,4,1,1,1,7,1769010.1122349,6057238.69547401
35,5,2,2,7,16,3027156.82969109,6954241.4074194
10,3,2,1,6,12,2144273.13157376,3214279.37023119
35,0,1,2,7,10,2288955.83312458,5605921.85114463
40,0,3,1,3,7,1758027.77947439,7110915.90323954
12,1,0,0,1,2,1139923.65546734,2145691.53519959
19,2,2,0,6,10,2036551.26528147,5019487.38346319
19,2,3,2,7,14,2143080.62562604,7549350.14749364
20,2,0,1,2,5,1174646.52861765,2534356.42523165
14,2,2,0,6,10,1738760.38131877,3366137.5432645
29,3,2,1,7,13,2638787.18805506,5865034.24917873
35,6,2,2,7,17,2704500.65629896,7037075.95815797
37,6,1,0,4,11,2081123.6532893998,5520781.54837351
32,6,1,1,2,10,2293377.84797133,5618189.54785133
40,2,1,2,3,8,1978159.73429359,6742533.00538801
12,5,3,2,7,17,2732705.87648416,8508461.38615901
15,2,3,0,5,10,1965437.2723400001,8734839.20866349
16,5,1,2,3,11,2041969.34267448,4745903.17260826
13,1,1,2,4,8,1417369.87948341,8067199.97265029
33,2,0,2,7,11,1358807.9795164,6948872.80119059
32,4,0,2,0,6,1175661.13855105,2523834.40342416
30,1,0,0,6,7,1715194.37265419,5369600.67328307
19,4,0,2,3,9,1676439.00559235,5779699.39700878
13,4,0,0,3,7,1615644.06728841,3903012.96470251
11,5,2,2,7,16,2576598.37203929,6903917.23724803
17,0,3,0,5,8,1795331.95752765,4746098.68799979
13,2,0,2,4,8,1568937.12023994,6485472.06380267
24,0,3,2,7,12,2163210.83739227,8209810.26492258
39,2,0,1,3,6,1921912.54964712,2678361.81366685
29,1,2,1,2,6,1306838.8381105,4429382.65330003
29,1,1,0,4,6,1248044.94014698,626047.458034873
25,2,2,0,3,7,1704976.81587751,5844224.22850978
28,1,1,1,5,8,1979104.41802465,5991171.01774511
13,1,1,1,6,9,2016769.77421048,2600993.4397142003
31,1,0,2,0,3,1077900.95779665,3206137.25869949
37,2,0,2,1,5,1488041.12612714,6753652.03292108
28,4,3,0,4,11,2050547.00999669,5845591.34292904
37,2,1,2,0,5,1511003.88915277,5882729.39563489
21,6,3,2,2,13,2143441.32244829,7176838.25229576
22,1,3,1,1,6,1406191.81673499,4441642.59823062
38,2,2,0,6,10,2146933.63300218,8112588.88474265
26,2,2,0,7,11,1991086.58174076,3719576.88582877
36,1,2,0,2,5,1497371.80692549,4022689.12087842
37,0,1,0,2,3,1183020.60653545,2140544.1871821997
17,0,0,1,4,5,1830204.78479234,3718698.09391707
19,6,2,2,2,12,2559123.97026859,10318900.0516819
19,3,3,1,2,9,2138817.96135344,6580199.45097482
14,4,3,0,2,9,1876886.66852464,4191436.51197528
34,3,3,0,6,12,1824241.32167545,8597842.49836558
17,2,1,0,4,7,1586790.67268532,2991416.11508113
31,3,1,0,0,4,1272251.25486228,5454081.24549295
33,1,1,2,4,8,1710907.53513052,3230639.46798996
33,0,3,1,1,5,1570024.20939249,4786417.7238873
24,5,0,1,2,8,1974875.72468108,5985356.10135606
40,5,0,0,1,6,1015525.5955107,4023196.91632335
15,3,2,2,5,12,2287538.81696194,7738032.57621972
16,4,0,1,3,8,2205061.98380632,4427117.20373606
30,1,3,2,1,7,1944432.7916125,6353442.77001692
19,6,1,1,0,8,1272749.17113511,3407425.69806918
13,1,2,0,0,3,1437207.2537968,4399100.86317216
11,3,1,0,0,4,1634758.62109742,3793744.28516947
38,5,2,2,0,9,2083485.97655632,6743031.58455434
16,2,1,2,5,10,1970055.2952472,3796219.59817591
22,3,0,0,1,4,1323543.07456154,5731636.90009415
28,1,0,0,2,3,1347752.39260195,5475474.80117383
31,3,2,1,2,8,1025689.84329099,5538399.65402053
31,0,2,2,1,5,1182142.38622754,6314701.77079342
17,4,1,2,6,13,1651173.36960036,6620465.35118767
15,6,3,0,2,11,1748726.81622326,6995893.60317601
28,0,1,1,4,6,1611889.15631832,5517211.08967605
20,1,2,1,1,5,1238828.80459859,4660429.53877689
17,0,1,1,3,5,1382285.71566469,3176283.44947792
22,5,3,1,7,16,2503175.07801599,10378806.000847198
21,6,3,2,3,14,2296717.99707481,6721482.79577865
21,3,1,0,4,8,1559954.6442926,4927989.59013017
17,6,2,0,5,13,1975368.29275873,8991050.38304109
16,1,3,1,2,7,1718364.42163499,7558177.73038163
13,6,3,2,5,16,2392073.78583685,4070081.60632231
39,6,3,1,7,17,1858517.28182535,5600684.4218182
27,4,2,1,6,13,2526721.21429428,7844030.1235543
15,3,2,1,1,7,1756811.02129517,6026701.96529978
31,5,2,2,7,16,2110319.2662822,6404588.78351411
36,4,3,0,5,12,2437076.57200803,7271009.84460178
32,2,0,2,2,6,1766177.12821646,7512049.32012197
25,2,1,2,3,8,1839089.26713611,6110842.73804182
29,1,0,2,4,7,2200577.93938707,6708885.13535491
23,2,3,1,6,12,2528414.95383743,9234995.62460576
22,4,0,1,7,12,2186476.17578724,5017725.85531641
16,0,3,0,5,8,1856096.11869374,4302601.42509575
34,5,3,1,3,12,2397623.72554949,6925495.86964162
32,2,1,2,6,11,1656450.63659932,5083852.79294787
30,6,3,2,2,13,1565610.44627272,7749453.24555549
23,1,0,1,7,9,2106774.43737427,10205065.442949198
33,6,2,1,3,12,2163268.62842761,6986362.54227333
34,2,0,2,1,5,963204.284859873,5678108.97656113
35,3,2,0,5,10,2104295.6834954,3666055.12824964
35,3,1,1,1,6,1477837.07466566,4829551.88098719
15,6,0,0,7,13,2497578.7586661,4261476.7905042
11,1,2,2,4,9,1950157.07694759,9125960.64190392
15,4,3,2,0,9,1507778.14550872,5503960.91905161
28,2,2,1,5,10,2167968.9181772997,2417485.62416027
27,2,0,0,2,4,1205412.0722929,5170712.66199444
12,5,2,2,2,11,1987124.90763373,9961705.32505687
34,1,2,2,6,11,2379775.56906399,5595751.81270012
28,3,2,0,3,8,1104890.00838074,7817753.50908155
25,5,3,0,4,12,3218697.9843567,9901427.89593216
37,5,2,2,4,13,2164468.07879982,5804976.23178704
31,3,1,2,6,12,2376598.9899502,5281599.67309834
22,1,3,0,5,9,2255844.39255957,6328754.1848351
40,2,2,1,3,8,2173268.67714145,4112123.92127786
24,1,0,1,5,7,1626012.56299621,4079313.20731571
16,6,1,1,2,10,2321404.27271211,7205263.07314596
38,3,0,2,1,6,1496984.73808102,3779854.91481724
38,4,1,0,3,8,1375234.732098,6883429.98419254
14,5,2,0,5,12,2054220.90736102,3586664.9869358
15,5,3,1,5,14,2256136.68470319,6689597.592841599
37,4,1,2,3,10,2062254.42409859,5043528.3457593
33,1,1,0,7,9,2158566.5223834,8564271.67617242
26,3,2,1,3,9,1706984.11616438,3726838.85234692
11,1,1,2,3,7,1630225.46187967,8712166.45809756
34,3,1,1,4,9,1974503.18681873,6915726.9940778
11,5,0,2,0,7,1838133.68330101,8320909.16644591
34,0,1,2,3,6,1658892.12090278,6439763.57791328
14,3,1,2,3,9,1945307.5008998,4726810.62688587
29,4,0,1,0,5,1527676.53529804,5453842.91296684
25,1,3,1,7,12,2288519.97853151,7021393.73654942
26,2,1,1,1,5,1329609.24025151,3662632.63550408
39,6,3,2,3,14,2400658.40480253,4927860.14368063
39,4,2,2,2,10,1702571.08837631,4311717.4840440005
39,5,3,2,7,17,3458002.1050724997,6102305.75409668
20,1,0,2,4,7,1490310.56371858,6637212.17598495
14,0,2,0,5,7,1305026.53594527,5597100.36565632
24,4,1,0,4,9,1816480.03821188,3529521.87813422
17,1,1,1,3,6,2057605.60597126,6272024.96776013
35,0,0,0,2,2,1305444.60696001,1569675.92141696
36,4,1,2,1,8,1717965.19084311,2973182.95007601
30,5,0,1,6,12,1978360.11403166,7280086.55516876
38,0,3,1,5,9,1624423.6601943,3676826.32207101
18,1,2,1,7,11,1806667.41738102,5793278.669378201
34,6,1,1,1,9,2063439.59315698,6786217.285009501
14,2,3,1,0,6,1442303.17182075,3474017.72623002
32,6,1,1,5,13,2887165.43600287,6033206.78437933
28,5,3,1,0,9,1843894.29606245,4037439.11606686
10,1,1,2,1,5,1224485.2838048001,6918477.44470674
12,1,0,1,7,9,1826923.03356773,5103455.367561701
11,3,0,0,4,7,1662070.49071303,7107907.91479118
28,3,1,0,4,8,1526634.47639067,3503273.46137495
37,5,3,0,0,8,2092848.76802704,5959877.10514189
29,0,3,0,2,5,1159798.93000524,4852725.39593311
30,5,2,0,7,14,1943112.32012091,7313364.77205437
26,1,0,0,2,3,1177812.11053836,2050457.08662477
11,0,0,0,1,1,1245687.29058518,2896054.88058404
23,4,0,2,6,12,2022188.46251271,8859799.42352676
11,2,1,2,3,8,1725327.65537607,4175520.86539444
40,5,0,0,6,11,2646137.23841534,5699810.08142392
16,2,2,1,5,10,2166970.4902259,5045381.40692352
24,3,0,2,6,11,2006145.3555903998,8179300.38637238
15,6,3,2,2,13,1774727.76510748,5956752.35917173
19,5,3,2,2,12,1843431.1951161998,5935138.67340684
32,4,1,1,3,9,1849948.21737408,6748771.30872833
18,0,3,0,0,3,1587275.49066774,2340542.84357897
12,6,0,1,7,14,2542839.19891325,9271450.22397055
40,6,1,2,1,10,1769557.1294658,4035326.10326489
20,2,0,1,7,10,2583156.89889046,2037116.33060905
11,5,3,1,0,9,1906548.80862937,6909656.15935294
37,3,0,2,2,7,1975306.11328403,7926871.07155473
38,4,0,1,1,6,1880397.89853391,3294723.01969564
23,4,0,0,1,5,1487206.46436407,5954411.94273684
23,0,0,1,7,8,1556562.86630148,7146478.55292241
35,4,0,0,6,10,1737481.73542009,3630790.76036889
21,4,0,0,1,5,1455608.51716787,5474623.81809673
28,3,2,1,4,10,1755449.19597934,5102128.67610658
17,0,2,1,7,10,1915330.22445885,4107693.96140643
33,1,2,1,3,7,1977999.48291031,5474359.58028594
29,2,3,0,5,10,2225514.94233458,949985.1964993121
30,2,1,0,0,3,1017099.13766239,2381970.57516763
27,1,1,2,6,10,1979816.87303869,8305112.37349481
32,5,2,0,6,13,2332587.54233778,9178245.89881904
18,1,1,0,3,5,1327560.4621040002,5940053.13031592
32,3,2,0,3,8,1423285.18037453,6921846.10266852
29,0,0,1,1,2,1102851.00291561,4148762.85902942
19,2,3,1,1,7,1377620.3161201999,4471175.58119081
31,0,1,1,7,9,1399316.59519146,5875653.34032543
30,5,1,0,4,10,2056680.7951184,5531708.568764
36,6,2,0,5,13,2455384.87950299,4503060.74581415
30,2,0,1,2,5,1489801.1661866999,4830417.47441786
28,2,1,0,6,9,1917037.15649315,2702815.61614264
33,0,3,2,6,11,2330750.77591944,5852417.52057014
11,6,1,0,2,9,2141360.1733298,3962603.33363266
25,5,3,0,4,12,2482142.8672778,6352836.10348124
38,1,0,2,3,6,1641672.56428861,8167898.05911596
13,0,0,0,7,7,1684117.87145184,2910387.00601025
39,0,1,0,5,6,1724310.18187,4789056.85943896
39,3,2,1,0,6,1924310.24466144,3935889.9592833
31,3,3,1,3,10,2414995.95777774,4150653.73063674
39,3,0,0,4,7,2060137.19361839,3931889.5943337996
24,4,3,2,6,15,2733505.67700444,5458381.60319889
14,0,3,0,6,9,1644200.84743416,4786831.84519259
18,0,2,1,4,7,1837128.57040088,5776349.30904858
15,4,0,2,4,10,2202673.2262348,5724422.41836258
34,6,3,0,7,16,2217399.07083195,8235819.01442385
39,2,0,1,0,3,1179508.22923864,694040.468975339
22,5,1,2,0,8,1085412.31281355,6671051.15911376
39,3,2,2,4,11,1928116.93035057,3979518.38625997
28,5,1,2,6,14,2273018.72690042,9834893.76633803
26,1,1,2,3,7,2111446.0752185,2391717.82915277
25,0,1,2,5,8,1602730.96012815,3487012.30236963
33,0,0,1,6,7,2465287.18702886,5427137.60256855
12,0,2,2,3,7,1805977.35351306,4718976.64291315
19,5,2,2,1,10,1689307.40691228,5614763.41162331
26,3,3,1,1,8,1874829.56434912,7036490.15287587
34,5,0,2,5,12,2227120.05397161,10626062.5916407
32,1,1,2,6,10,2065575.67355861,5849397.94291833
40,5,1,2,6,14,2072382.82439956,6254053.08459462
23,4,2,2,4,12,2213754.8542592004,6980325.52309243
37,1,2,2,7,12,1998469.78993381,5370500.84603439
33,5,0,0,7,12,2300294.81852134,7823916.06304047
21,0,0,0,1,1,1524256.2217841998,6205331.34025842
37,1,3,0,2,6,1549327.59295066,6447303.18633227
38,6,0,0,5,11,1939824.86768424,6440075.50318895
23,2,1,0,0,3,1224389.96618865,6677930.39816988
37,5,3,0,2,10,1994037.39950384,7428272.93864808
15,0,0,2,6,8,2300190.00493202,6422021.50665951
28,3,2,2,0,7,1712143.95587656,4648435.33808832
39,6,1,2,1,10,1538846.66195468,4978295.14532853
39,4,0,2,4,10,2179522.40740534,7557795.25616299
13,5,0,2,2,9,1963548.19354495,3192704.75571343
37,1,1,1,2,5,1320492.66396523,3176005.89114871
31,3,2,2,1,8,1751759.22410009,5286032.31586662
35,6,0,2,0,8,1657048.73299163,5111453.92745036
32,4,0,1,3,8,1708442.11030863,7867558.63727432
17,5,3,0,0,8,1764545.9652563,2659114.28718005
15,5,3,0,6,14,2569815.26556807,4390187.3017393
13,6,3,1,2,12,2101431.36947553,5990297.10659637
13,0,3,0,7,10,1771514.54430918,4540378.82083611
17,1,1,1,7,10,2116246.92803477,5713261.96920753
26,4,0,1,0,5,1254955.08008653,4734745.12919193
34,6,3,2,0,11,2590506.95296524,7451099.25016582
13,1,3,0,7,11,1936933.95911895,7385096.88668526
35,0,2,1,2,5,1532939.70743877,6329140.4736677
14,4,1,1,4,10,2115452.60384377,3977873.92642374
24,5,1,0,5,11,1375152.3615889999,9206240.89583063
28,2,3,2,0,7,2149736.85720865,4424842.52096605
25,4,3,1,6,14,2168382.28671043,3134366.69024304
34,6,1,0,5,12,2523583.2827287004,3693477.66360918
28,5,0,2,4,11,2116007.18056065,7220107.2573008
12,5,3,0,6,14,2735576.83124634,7819786.18863282
25,1,0,0,3,4,1699598.73408046,3858589.4169865996
13,2,1,2,6,11,2656978.03821428,7429632.05153364
40,1,3,2,3,9,1947779.70668407,3183747.05425199
38,0,2,1,4,7,1109621.90855884,5572266.47944273
32,1,2,2,3,8,1858661.103504,3858583.45954998
19,3,2,2,6,13,2757025.20444716,4505181.43229718
13,0,1,1,6,8,1669305.38892177,3725517.22664175
19,4,2,0,5,11,2374585.92252701,5952969.13885343
11,1,3,0,0,4,1545315.98439671,3220335.52744089
21,1,0,2,2,5,1626868.38518261,4570679.87877346
21,2,0,1,4,7,1848924.90753835,3816177.62699103
28,3,3,2,2,10,1894548.60260023,2889721.79160681
37,2,2,2,1,7,1437331.41065026,5443226.51287042
29,4,3,2,5,14,2834126.09086875,7089004.07149006
29,3,0,2,3,8,1583073.25160353,3747052.98079727
27,0,3,2,2,7,1564627.723364,6540012.63964007
12,6,3,0,6,15,2047157.27976467,7584725.42761552
13,0,1,0,7,8,2663748.42018685,6512951.86977405
19,3,0,2,7,12,2104633.54929446,8899864.202522501
23,1,3,2,4,10,1909817.26246536,4227149.29506997
35,5,2,0,7,14,2893673.26724459,6704431.63476923
18,0,2,0,5,7,1998467.77776229,7119235.86917385
25,0,2,1,1,4,1306310.02519875,3576669.25276416
22,6,0,1,4,11,2170147.96956304,7521721.98232714
32,6,2,1,7,16,2540747.38234436,7783066.4613332
40,6,0,2,7,15,2123966.94010802,10250478.2627513
19,2,3,1,7,13,2586392.33865434,7228656.5333433
38,6,2,0,7,15,2328994.27093977,7643745.86334911
20,4,3,0,7,14,2689265.84658619,4598575.84887831
13,1,1,0,2,4,1157106.34599562,5869831.79747534
21,0,3,0,7,10,1979970.9697266002,5884689.09009309
18,4,2,2,1,9,2145659.03244346,5000267.82407504
18,3,2,0,0,5,919801.662382636,4310563.71294106
18,3,0,0,6,9,2016560.82993087,7141410.56260039
39,1,2,2,0,5,1809119.34600977,3414970.97768931
13,5,0,1,4,10,1684039.93296289,4561994.696611401
21,5,0,0,0,5,1327767.84730571,8368786.30862744
33,2,0,0,0,2,1377121.90351539,3269939.21230879
21,3,1,1,2,7,1349842.35145288,6583807.44169382
19,2,0,1,3,6,1595101.68414644,5058609.52967161
23,2,0,1,3,6,1979593.58234713,5016561.83220024
34,2,2,0,6,10,2155044.70587948,3501609.35872446
15,4,2,1,5,12,2012738.66950618,5801496.52106276
25,5,1,0,0,6,1662940.78119421,4666417.70763929
40,4,1,0,0,5,1310695.96118079,7026070.90796169
17,5,3,2,0,10,2952098.97134272,5009687.58025222
33,6,2,1,5,14,2563210.22271655,6362599.31797556
40,4,1,0,3,8,1941670.88482587,6701245.09017045
37,3,3,2,5,13,2001055.06812512,5403068.48972063
40,6,3,2,1,12,2786147.15784143,7846945.4828283
19,1,0,0,3,4,1653435.22947959,3863173.45354366
37,2,1,0,0,3,1342798.75637659,980937.968460643
14,1,3,0,3,7,1962907.78637754,7413297.30168391
30,1,0,0,1,2,802148.71434838,3706145.4178183
19,5,2,1,0,8,2013565.05367049,4689545.92237305
11,1,3,2,4,10,1592557.32389077,3027798.91937685
39,0,3,2,5,10,1447377.28386324,5695873.77378432
17,4,3,0,3,10,1786006.27959815,3752302.59742371
12,1,0,0,4,5,1097496.28054455,4805426.35224732
37,3,0,0,6,9,2232117.20738702,5681927.43777754
23,5,1,1,3,10,2355521.42100636,8805910.76177566
22,4,2,2,0,8,2049533.46333909,4403792.10332579
22,0,2,2,2,6,1394027.17942296,5603293.28134979
22,6,2,1,0,9,1661031.79631556,5419704.86008644
10,0,3,1,6,10,2154150.43777039,3850826.01146594
10,2,0,1,7,10,2317396.52367596,2393192.26745245
31,4,0,1,7,12,2519769.81721266,4159832.50756335
14,0,1,0,2,3,2061468.58514579,5577081.12520216
16,1,3,0,2,6,1826329.25194204,4728125.58227074
14,0,1,2,6,9,1892055.02461594,6729558.34798497
10,5,3,2,2,12,1994843.56826095,4832769.61776712
18,5,0,0,1,6,1764933.74715702,4730481.23942121
35,1,1,1,7,10,2138975.54994349,5040029.49515441
37,6,1,0,0,7,1454997.35046896,5007002.99287206
12,0,0,1,0,1,1175331.52396934,2524886.70712068
24,1,2,1,6,10,2016801.29585814,5770583.54697469
19,2,2,2,2,8,1342421.48523956,7017538.07844479
18,0,0,2,7,9,2115333.33092876,5855925.31710227
18,0,0,0,6,6,1607013.30653243,2950216.86651526
20,0,0,1,2,3,1055920.55892949,6372362.12351529
15,4,2,1,5,12,2430280.64811568,6431644.39517716
26,2,2,1,7,12,1420443.17509393,7067882.58470367
25,5,1,2,5,13,2283668.78000492,8895430.11881093
19,6,3,0,7,16,2864227.54573905,9856400.322050901
40,0,0,0,4,4,1598454.78923733,3852529.69282968
11,4,2,0,6,12,1942427.71427914,6751439.14544855
14,2,3,0,5,10,2481036.86448641,3825544.16204018
26,4,1,2,1,8,1897420.28836262,7137586.29139848
18,1,3,2,0,6,1521068.28453775,4117492.80594403
16,0,0,2,6,8,2127880.93652608,4654941.62737561
35,0,1,0,7,8,1754901.04191116,5620630.42331695
29,2,1,0,7,10,2119590.86704509,5082823.19796428
18,6,0,2,1,9,2143064.27444404,8099338.68511147
29,2,1,1,7,11,983960.637844554,10935565.1408305
34,1,3,1,3,8,1470124.14105392,6123178.71335387
14,1,0,1,2,4,1739770.52728523,8415166.98197024
22,5,2,1,4,12,2380591.88194989,5186429.54829886
17,4,3,2,5,14,2797332.97748067,11884134.295369199
20,2,2,1,2,7,1585006.43589258,2706089.97330821
36,4,3,2,7,16,2137654.54212843,10920966.5775888
22,1,2,2,5,10,2166720.86331624,6674265.67846895
18,4,1,0,3,8,1946547.5514362,6750444.76193507
32,1,3,1,1,6,1342032.48303392,4904573.13757805
19,6,3,2,2,13,2827769.18863339,8516823.7207941
19,1,3,1,6,11,2236114.90213962,7816409.03287768
30,2,3,0,6,11,1820540.06590517,7046832.39988027
12,6,0,1,6,13,2521479.66927696,3390013.17910949
27,4,0,2,3,9,1988454.33125955,8373642.61636769
21,0,3,1,4,8,1956709.24297313,4271435.180581201
37,4,0,1,1,6,1507477.92552257,3949032.43332711
12,0,1,1,4,6,1451488.18818263,7270234.97664614
35,4,3,1,7,15,2475368.37450869,9215090.07266683
40,2,2,1,3,8,2056399.7906861,4302014.723382
40,0,2,1,6,9,1774370.39814448,6677802.29251755
37,5,1,1,7,14,2242900.86578534,9256976.08419631
36,0,1,1,0,2,1583459.03421884,3128690.81416948
36,6,0,0,3,9,2040073.31421763,7820525.66386101
15,0,0,2,4,6,950326.827566267,3850789.52983917
14,2,1,0,3,6,1762499.1705977002,1689020.27590465
30,1,3,0,3,7,1521375.36532822,4685163.38935215
31,3,2,1,4,10,2102716.13518512,7592536.55432433
24,0,3,1,5,9,1359988.05335687,6637142.79984525
39,1,1,0,7,9,1473146.54395042,4802788.78852183
20,6,3,1,4,14,2507009.61172428,5959987.4546018
10,4,2,0,3,9,2298596.03000988,8295093.11503564
39,4,3,1,0,8,1467478.86600766,4933730.3735238
25,5,3,0,6,14,1192742.38802847,6896909.93649922
13,3,3,1,4,11,1673228.68261263,7059327.178962401
11,0,3,1,7,11,1902299.94359698,4598906.87204575
39,2,2,2,0,6,1252843.06660355,3764282.74025488
19,1,2,1,6,10,2306557.7297537997,5905175.42465471
18,5,1,1,7,14,2253007.47046778,9178888.73084755
30,4,1,2,6,13,3197365.14480417,7155518.79541011
18,1,0,2,4,7,1735822.2885891004,6741630.83690081
15,1,1,1,3,6,1490128.60250417,6231155.55293679
22,6,2,0,5,13,2702032.6937328,8776552.95694776
23,1,1,0,1,3,1021941.46530857,4290711.51703796
34,3,0,0,0,3,1365956.65943818,3247078.54562515
26,4,1,2,1,8,1641547.96446655,4768649.78601481
21,3,0,1,4,8,1507906.82125376,6697266.57183377
26,5,3,2,5,15,2760406.84926311,6188533.50148356
20,4,1,0,5,10,1618738.98344343,7950610.84107513
30,0,2,2,6,10,1963118.56339219,8046698.87556641
37,4,1,0,1,6,1916041.55261812,4174193.23512653
15,5,2,1,2,10,1946595.23447843,8507227.14950929
20,6,1,2,5,14,2352454.38690452,4788143.51517286
17,4,1,1,2,8,1889080.92316046,5699045.60128218
40,2,3,0,0,5,1152406.78920293,2416079.46643482
34,0,1,0,1,2,1565435.72054849,3927013.53407738
21,3,0,1,1,5,1260586.46534873,4880159.8179594
29,1,3,1,1,6,1861495.18573613,4659490.40017301
23,3,2,2,7,14,2603249.78801222,5992173.87437491
13,4,2,2,0,8,1739507.41694734,3416220.08984963
23,1,2,1,2,6,1758798.03136915,5008423.8197417
20,0,1,0,7,8,1867967.65179753,6817209.07329232
34,0,3,2,3,8,1701445.20421412,5924803.08798427
40,0,2,0,6,8,1486617.49621377,1486617.49621377
11,6,3,1,7,17,2670216.70127112,10772749.0831885
31,4,0,2,1,7,2412312.24671428,6509826.80115234
26,2,3,2,6,13,2501057.36220644,6220340.83314312
31,6,3,0,3,12,2016640.6563836003,3237035.70746247
32,0,3,2,7,12,2249696.47839491,7411487.62120771
28,5,2,1,1,9,1898424.40244031,6258344.25830802
29,1,3,2,2,8,1868964.62015141,6980812.93244928
27,4,3,2,1,10,1849009.06501956,4782567.31334329
13,0,3,1,7,11,2431846.20105135,5589251.31691912
21,4,3,1,5,13,1871421.92674012,6038847.04444616
34,6,1,2,5,14,2321944.32970584,6235013.2427956
40,5,1,0,2,8,2086472.92260509,7453269.41909778
39,4,0,1,6,11,1998877.87232518,4796821.36015215
30,0,0,0,5,5,1670408.77067225,6030951.35634294
38,2,1,0,1,4,1132099.78369416,3460726.07614436
13,3,1,2,2,8,1380112.19210579,7189622.1272468
25,1,1,0,2,4,1244730.36512126,3934770.96739038
20,1,3,2,5,11,2800281.53933163,5138460.60257587
27,3,0,2,2,7,2018736.52602998,3487283.6646002997
21,1,2,0,5,8,1205042.01051359,7638714.66613399
39,3,1,2,1,7,1968619.76554337,3857236.08156531
11,5,2,2,1,10,1578467.15131601,5423558.09175497
19,5,2,0,4,11,2541132.30236961,4902718.89146644
39,5,2,0,4,11,1915145.74763224,6035391.15519828
16,2,1,1,6,10,2181591.96602821,8386854.90504643
28,5,2,0,7,14,3054555.22957993,5381838.61077823
12,5,2,2,6,15,3404090.51686209,4111786.08036493
22,2,1,0,2,5,1674837.05903471,3724667.09050453
11,0,0,1,4,5,1388292.28979287,1765151.58494759
11,3,0,0,4,7,2092359.10006854,5109978.16949065
35,4,0,0,0,4,1478806.63427759,4307810.4951262
15,5,0,2,3,10,1190980.03766217,6482931.94530581
32,2,0,0,0,2,1036131.71703002,1384959.41407768
38,4,0,0,4,8,1755760.1656042,6154231.63537208
35,3,2,2,5,12,1753706.65226143,8868050.10013619
31,6,0,0,2,8,1182921.38766571,3449188.66066216
20,3,2,1,1,7,1521230.95782527,4172742.25852427
14,4,1,2,7,14,1942096.06893575,10258837.672102198
24,4,0,2,7,13,2981627.05081737,7398919.45917875
21,4,2,2,3,11,1691059.14687772,6364565.80316674
27,4,1,0,6,11,1635213.48312439,3214389.55667567
18,1,0,0,4,5,1790722.08084445,3975245.80760239
38,3,3,2,7,15,2407472.0330343996,4187682.92743866
12,3,2,1,2,8,1774059.59822935,6124340.91781432
37,4,3,2,1,10,1497782.63252463,5604506.399101799
36,5,3,0,3,11,2199208.09465283,5978146.1230625
33,6,3,1,1,11,1990124.23979969,6785254.69727932
12,1,2,2,6,11,2175285.68897056,5379908.76212052
23,1,2,2,5,10,2053183.83652239,5691727.32803531
17,0,0,1,6,7,1566361.34900667,4375992.01938614
25,2,3,0,4,9,2269321.66101079,5581692.831950299
17,4,0,2,5,11,1582621.63703976,7988313.85724624
15,3,2,1,7,13,2923384.83052029,8734975.75695278
14,1,0,2,5,8,1794039.01286572,7853742.80289373
14,5,3,0,5,13,2256717.69382283,8447695.76034985
17,3,2,1,4,10,2290739.43874116,5374899.11377495
32,3,1,2,5,11,1680827.45093083,7670871.90768345
26,0,2,2,1,5,1805095.63588266,4065024.82535305
39,0,2,0,2,4,954354.9139099941,3847521.46212639
24,0,0,1,6,7,1614075.2016387,4175949.40187027
13,3,3,2,0,8,1990403.2564999,7890425.89712202
28,3,0,0,3,6,1733908.63035897,6405608.86533126
28,6,1,1,3,11,2178250.00500301,1785531.48131647
37,2,3,1,7,13,2769131.93724583,8171063.66611931
12,0,2,1,0,3,787571.833932141,5711569.44734817
17,0,3,1,0,4,1322666.60168836,5335283.24093694
37,6,3,2,2,13,2140383.2043474996,9767180.70358922
26,0,2,2,6,10,1811878.05691322,5252283.36885114
37,6,2,2,0,10,2046728.08939153,8412857.73146121
36,6,1,0,5,12,2081056.27648654,9024357.97056852
38,6,1,1,3,11,2414894.38681196,6140639.75915506
12,1,2,0,7,10,2007061.46715678,3500215.09374752
33,2,1,1,6,10,2163324.1883215997,5585872.63457059
22,5,1,1,3,10,2342389.53419735,5389003.44020875
15,1,1,0,5,7,1709431.14146961,4263129.44000722
11,5,1,1,7,14,2896372.46656943,6049443.18943665
23,4,0,2,3,9,1425345.8932666,6074472.71051974
39,5,2,1,7,15,2836649.88462645,8671999.34331786
34,2,0,2,5,9,1853394.6112523999,6030210.6372458
28,6,3,1,6,16,2169461.26171337,10488702.774385002
14,6,2,0,6,14,3012436.11196355,7856190.68308287
26,6,0,2,6,14,2555331.47398439,2719622.65330729
34,1,3,1,2,7,1856462.24259463,3229660.58790181
20,5,1,1,2,9,2153280.47612514,7244154.69086318
15,0,0,1,0,1,992080.013763408,3329531.90763907
33,5,2,1,0,8,2122703.4408639,5712899.31969939
28,4,1,0,2,7,1568071.36637847,6423526.98455853
20,5,0,2,7,14,2944704.96076671,10241098.9471375
39,4,1,2,4,11,2379452.30100148,4627479.03443406
12,6,2,0,4,12,2247073.63027778,6229716.62173883
26,2,1,2,0,5,1613318.33040024,6031493.04927017
34,4,1,1,0,6,1300002.45222324,4699790.74872959
40,4,2,1,2,9,1938477.17703272,2287727.22362986
13,2,3,1,4,10,1504726.27123523,6500508.80317531
31,2,1,0,7,10,1235645.47756537,7988640.53050064
14,3,1,0,6,10,1833273.43762145,5359040.72443355
40,2,0,1,4,7,1952159.15761166,5980402.93861794
17,2,2,0,1,5,1532447.08490748,5763559.53355158
35,1,0,2,1,4,1297741.29514177,1710739.75557843
37,5,1,0,4,10,1931677.84839209,6647440.42964383
21,0,3,2,7,12,2293368.00434215,6585951.20168736
15,1,1,1,4,7,1863043.3394361,4169362.80371443
38,3,2,2,0,7,1616206.69404089,4531097.40022735
10,3,0,0,0,3,1192028.63079414,1809882.53782092
35,4,1,1,6,12,2241798.91898293,8556147.917729
27,4,2,2,0,8,1954426.49688748,4973732.31438919
26,3,2,0,0,5,1359021.19835638,7132265.21861244
20,4,1,1,1,7,1853451.06692187,5023015.76862479
11,5,2,0,2,9,1632761.37854449,4115872.60293837
34,6,0,1,7,14,2888018.16467884,7061336.17648825
30,2,2,1,0,5,1576888.27737233,4682223.27734813
13,4,3,0,6,13,2351698.88694645,4430468.25691354
18,4,1,2,0,7,1750675.94973051,7015384.38857396
38,0,3,2,1,6,1475226.75516808,2288860.66566686
25,1,2,0,1,4,1266621.52088928,2067860.54293782
23,2,3,0,2,7,1898056.99728714,5573802.6010857
29,5,1,1,0,7,1536529.85883333,4636303.34437985
32,2,0,0,2,4,1657521.30044153,3931305.66464714
13,1,0,2,7,10,1839908.19455971,5806589.46740485
21,5,0,0,7,12,2528024.35275978,8789711.27004649
12,6,3,2,0,11,2596346.89251824,4179081.00303882
31,0,0,0,6,6,1812237.64713834,2426634.1144535
38,3,2,1,0,6,1402827.98369445,6904229.83120658
16,6,1,1,7,15,2507107.85590715,12073594.0266106
16,0,0,2,2,4,1430109.38571216,4709273.01579499
40,5,0,2,4,11,2182670.25110193,7766874.60722535
33,0,3,0,2,5,1273852.82884553,4084486.38584916
20,2,3,0,7,12,2370265.21737654,5108485.93357201
13,2,0,1,5,8,1894819.6494681,4712713.40768065
20,4,0,1,4,9,2292617.51552893,5906716.55321119
40,0,0,2,4,6,1375591.15760304,4200978.43254931
27,1,0,2,6,9,2246336.47358932,4360162.03948922
19,3,2,1,3,9,2273203.67307564,7883318.31612675
30,2,3,2,7,14,2495815.39097239,8143698.55023619
16,3,2,2,5,12,2322634.6200106004,9587341.58517019
32,0,1,0,5,6,1738363.03142958,4877342.41633227
12,4,1,1,7,13,2380050.36947592,5811941.42401639
12,4,2,2,4,12,2173403.62399225,5834625.0160137005
33,0,0,1,1,2,1327157.58307275,3286936.06474854
39,3,1,0,6,10,1858450.20551783,3275018.45118787
28,1,0,0,5,6,1773737.98840777,5043472.28038622
16,5,2,1,5,13,2437040.53764254,8092459.27151313
32,6,1,0,4,11,2195744.09622062,7219448.85781639
11,1,3,1,4,9,1933560.28484615,7640655.85116577
14,4,1,2,1,8,1772168.35857765,5883735.19905471
12,6,1,0,0,7,1831931.15196196,7338099.99797862
24,0,1,0,7,8,1076585.38908893,3496418.06518038
37,5,1,0,3,9,1899096.97998436,7556556.01595792
12,3,1,0,7,11,2840511.84922285,7381822.49792832
13,0,1,2,7,10,1844702.13612796,4258673.35311959
32,5,0,0,3,8,1986128.55814715,4145327.2551101
22,5,3,0,2,10,2521040.65216025,5029293.37006232
33,2,3,2,6,13,2770880.35547034,8617424.62101194
37,3,2,1,2,8,1717590.31161303,6180207.87516196
14,4,1,1,4,10,2064979.59537059,9602556.14169424
20,0,2,1,6,9,2183725.47370764,7035768.16416054
24,3,0,2,7,12,3061026.51978921,8251317.653159101
18,4,0,0,5,9,1691249.59745941,9555413.23067973
14,6,3,1,4,14,2687536.58298238,7724423.58322518
36,3,3,2,6,14,2583670.58296895,5865007.489834299
33,6,2,1,4,13,2047065.00855563,3069200.59393985
11,4,1,2,3,10,1940156.51998639,5731382.81602491
20,4,0,1,5,10,2415676.42632507,10202855.6006504
36,5,3,1,5,14,2445688.59642488,5967791.79398247
18,3,3,0,6,12,1796163.42605321,5396055.99781175
12,2,1,1,5,9,2123311.10885472,4704193.43598775
18,2,3,1,1,7,1739908.16705496,6355802.60312572
40,5,1,2,3,11,2329892.19900191,5865089.21393058
36,2,3,2,5,12,2427117.99273164,8919140.65617104
31,6,3,1,4,14,2744565.58716662,7387180.13193042
37,3,2,1,0,6,2007017.1971862998,5932434.94084301
18,0,1,2,7,10,2344720.87275234,6790105.08879779
17,1,2,1,4,8,1439403.6940398999,3519776.07037031
28,5,0,2,2,9,1934438.08899719,6404106.61708262
11,2,1,2,4,9,1934597.08945338,4614075.46983667
36,1,2,0,5,8,1892792.39389698,4071196.37900766
32,3,2,1,0,6,1707948.56476359,3997490.66796492
28,5,2,2,0,9,1880795.82852647,5447007.18729352
25,0,1,1,4,6,1651852.4646848,4896123.93021
25,4,3,1,3,11,2330806.3052788996,4996420.50543883
16,2,2,2,0,6,1605913.66344558,5586341.66817807
37,3,1,0,7,11,2231271.12343002,4232836.4300408
16,2,1,2,2,7,1266494.63376442,3182085.09474563
17,6,1,1,3,11,2533670.43154471,4778201.67975806
21,4,2,0,7,13,2145986.03253564,3913423.52612023
23,1,3,2,5,11,2337402.10008018,3958154.79428061
35,1,1,0,5,7,1952699.97597007,6243056.64520352
24,6,1,0,2,9,2123957.87010991,7724629.96433393
26,6,2,1,1,10,1648970.41646933,11243778.825932
12,2,1,0,0,3,1383612.1633918001,4110800.38975913
25,4,1,2,6,13,1965668.39903691,5677314.83765386
25,4,0,0,3,7,1134298.38648068,5951057.24514772
22,6,2,1,4,13,2431442.92274343,8939415.57654054
13,3,1,1,2,7,1716263.91310591,4679358.2830324005
15,0,1,2,5,8,1654922.05333358,3913463.90752339
19,4,2,1,2,9,1758947.33645716,8100583.81120847
11,1,0,0,5,6,1967568.04026858,5969108.98290498
34,5,1,0,5,11,2360483.52713385,3557656.35753396
35,0,2,0,0,2,1534288.99521217,6098019.27043293
22,5,2,1,0,8,1159238.89242148,7193227.69270764
21,2,2,2,5,11,2356280.33333127,7543702.24613095
28,2,3,2,2,9,2084833.13350867,5530898.3248912
30,1,2,0,6,9,2443295.270299,6028877.44846894
36,0,3,1,7,11,2217954.88937206,6743047.74018402
14,0,2,2,6,10,2336949.08450283,4135347.97410493
17,3,2,1,1,7,1578212.71623114,4691661.28945535
32,1,3,2,3,9,1888728.46527344,5054366.22981084
21,1,1,2,3,7,1765008.42436786,4734295.63989146
35,3,3,2,2,10,2026098.81574365,5424786.57881933
20,2,3,2,4,11,2346943.76904037,9140870.54410935
13,1,1,0,3,5,1479326.89787792,2833904.56351461
26,0,0,2,6,8,1897285.65123413,2846392.25269336
22,2,1,1,4,8,1442733.91777047,6996877.18347025
16,4,1,2,0,7,1315521.20204635,6347353.19417962
37,5,1,1,0,7,1842610.87725477,5824085.41495237
10,3,2,2,6,13,3298603.92716353,8144632.96731913
15,3,3,0,5,11,2115010.66550077,7915676.03471887
26,5,2,1,4,12,2349021.15874372,7768741.08279416
16,5,0,2,2,9,1901794.60211496,6576876.91462727
30,5,1,2,3,11,2075437.60224739,8816919.68572525
23,2,2,2,4,10,2374148.73564147,7766275.02803291
26,4,3,1,7,15,2255782.99758707,6225233.80698593
28,0,0,1,1,2,1378240.02641485,715467.6865572471
28,0,3,1,0,4,1416240.32842748,5757067.60006504
38,3,1,2,6,12,1501657.93622679,1881166.9626303
11,3,2,0,1,6,1583899.73643353,3674422.92468932
16,6,3,0,0,9,1665900.74931478,6600734.12617114
28,2,0,1,0,3,1024433.20595681,1229891.42956568
40,3,2,2,5,12,2484289.00743278,7432578.70291654
21,6,0,0,1,7,1578136.28302962,6160687.73736673
33,1,0,2,3,6,1998702.51467554,6525245.217966599
38,0,1,1,3,5,1423124.3162476001,5272472.04927803
36,2,3,1,0,6,1455992.02076125,7794068.51309636
26,5,2,0,6,13,2333777.51976608,6055031.238228501
29,5,1,0,0,6,1580074.77346123,5835273.22850419
37,2,3,1,5,11,2523863.77247118,7482085.3173196
35,6,0,2,6,14,1939944.83289841,6876355.75262178
17,2,2,0,6,10,1801568.09721972,5646600.163725
34,3,2,1,6,12,2914297.14933951,7122615.9478192
33,6,1,1,0,8,1775876.8576304,7267074.44610554
16,6,2,1,6,15,2827410.77642595,3746260.91320034
23,3,2,1,3,9,1837046.49547532,4403277.27810159
21,1,3,1,3,8,2039948.68921721,7102978.00045467
28,4,2,2,1,9,1425039.27665416,7897415.34363667
36,0,0,2,3,5,1764154.49268373,3736813.97881582
26,4,2,2,1,9,1644593.92692461,3318820.53526573
36,0,1,0,0,1,1063194.46290235,3432540.36799719
16,2,0,1,3,6,1026495.0531095,4360364.653161
21,2,2,0,2,6,1536018.4601151,3770950.26866397
10,5,1,0,0,6,1335037.46046136,6247104.53509719
27,3,2,1,5,11,2097338.58367238,6427314.44020906
23,0,0,0,4,4,1483967.63614961,4470323.07790698
14,4,0,0,1,5,1567683.07403996,4477901.40906617
27,1,1,1,5,8,2229650.13658816,4270095.14830613
19,3,0,0,4,7,1246559.90490073,5141923.24714792
25,0,0,2,4,6,2223663.30191091,5403409.35455504
33,0,2,1,6,9,1906390.19889971,2400884.75748078
24,0,0,2,2,4,1410430.9737081002,2815309.88867811
27,5,0,1,1,7,1814109.18126509,5754035.37761008
37,6,3,1,3,13,1976768.19997711,7617560.87787204
36,0,0,1,5,6,1812820.28694338,3321818.07947932
23,0,3,0,0,3,1208245.29964347,2728811.85740613
38,3,3,1,1,8,1816005.88751871,5052893.60368462
35,4,2,2,7,15,1830275.56558898,1401143.28956207
28,0,3,2,6,11,1563372.13523152,8573903.07655747
38,5,2,1,3,11,1803505.47705359,4805284.42018329
35,0,2,2,3,7,2098098.53942574,5322241.98697759
36,4,2,0,1,7,1894259.91190857,4177755.75650458
10,6,2,2,1,11,2044780.23889256,6885202.06800573
27,2,1,2,7,12,2222130.77866214,8492996.06176932
29,5,1,0,5,11,1497146.9373482,5798562.82154722
14,4,3,1,2,10,2167508.90302953,4989017.96679633
19,5,2,2,3,12,2406286.6008116,4728596.50302751
22,1,2,2,7,12,1877090.50567946,6190785.82653029
12,6,2,1,0,9,1684107.5139531,3632845.49873746
15,4,3,2,0,9,2005359.88355395,7803169.65541468
39,3,2,2,3,10,1446874.65318839,6146021.26148035
14,5,1,0,6,12,1985157.75534743,5126431.40381359
22,1,2,2,3,8,1478888.88135607,6851638.07945128
20,4,2,1,0,7,1720146.97084396,7171513.49680231
13,6,0,2,5,13,2308340.32413605,8160166.87588641
20,0,2,1,0,3,1630397.52935378,1650316.47098267
18,0,3,1,4,8,1853331.96178157,5389850.15910916
20,2,3,0,7,12,1786548.84430569,4101110.3206021003
20,1,0,1,3,5,1483256.98611087,4260380.52213319
32,2,0,1,4,7,1581455.60215577,7662900.57476893
40,4,3,2,1,10,1538182.24357539,8144187.12043533
40,0,3,2,4,9,2193770.15728576,5192099.47843347
21,4,1,2,5,12,2583904.28816195,5931582.03281201
13,5,2,1,2,10,2269640.60333871,7504350.84340199
36,4,3,2,1,10,1482795.43920248,8243923.36857369
26,2,3,2,1,8,1510868.29727746,5376033.41824144
28,2,3,1,3,9,2123235.34677902,5171026.64153571
38,6,1,0,5,12,2358280.7545107002,6491338.86136043
37,1,1,1,4,7,1964129.3004808999,3112488.87417497
34,3,0,1,6,10,1868335.29421791,3951845.84376123
26,6,2,1,4,13,2299016.29399489,7209508.75761558
37,0,1,1,5,7,1605476.73587135,4559891.41908763
10,0,0,0,6,6,1205255.66097668,4915488.42115792
34,6,2,1,5,14,1859093.68004012,9026479.60502292
34,1,0,2,3,6,1373335.7069131,4963176.83692558
26,6,1,1,0,8,1803294.47561816,6284455.30927022
19,1,3,1,5,10,1604350.63761795,5615206.93539609
14,0,1,0,1,2,1108880.78014074,3665772.78410762
28,4,1,0,0,5,1282753.10096516,5927886.23394261
10,1,3,0,4,8,2120548.81367104,4279529.78008906
31,4,1,0,2,7,1468757.90893734,3731917.47605791
38,4,1,0,2,7,1631050.47848787,4273908.13204213
14,6,3,0,6,15,2637579.6220597,5226809.24097622
33,0,2,1,1,4,1359990.88159569,3592574.08455671
31,2,0,2,1,5,1326391.76137503,6948392.83432532
17,4,1,2,5,12,2499432.16852484,7578219.98814738
15,0,2,1,7,10,2229348.38194666,8278143.03435198
16,1,0,0,0,1,710976.98354471,3601114.74671226
24,2,2,1,7,12,2577623.1676192996,6851949.11398231
18,2,3,0,3,8,2040598.1292978001,6488919.89905215
33,3,2,0,6,11,1814941.66125281,5946704.48221914
31,0,1,2,3,6,1448618.0153384,5140144.69817908
31,2,0,1,5,8,1732272.92182068,4926138.93232454
22,4,0,1,3,8,1593111.2767856,5457723.41476
21,2,3,0,6,11,2069291.3144381,5676795.66414423
37,5,3,0,1,9,1258365.21193062,3120032.99006956
38,2,1,2,4,9,1905393.53139431,5518163.55295908
38,1,3,1,7,12,2087405.31333261,8216428.93483163
10,6,3,0,6,15,2406829.37400979,6557262.27291527
37,5,2,1,5,13,2301326.3548821,6831330.90815474
19,1,0,2,6,9,2128232.44111264,3592416.59884644
34,0,3,2,4,9,1350754.35099221,5040443.56672414
33,0,1,2,5,8,1832843.38064204,5811778.07024342
31,4,3,0,2,9,1447859.57635044,6440015.18608734
30,6,3,2,3,14,1659314.41316191,8253331.16005576
40,6,0,0,7,13,2782846.50436253,6734647.01369452
22,6,1,0,4,11,1760667.41413291,3518096.36849568
26,4,2,1,3,10,2616538.23049503,3440996.56374398
12,0,3,1,7,11,2389914.47499866,4874577.28618851
23,6,2,1,3,12,2217714.63400983,6336567.52167309
35,1,0,0,1,2,1462259.06000309,3711875.37996297
28,6,3,0,3,12,2293551.99910703,5163509.88236581
10,1,1,0,0,2,1187231.13258645,2740107.32010302
31,5,0,1,4,10,2125569.17177267,7808333.1057279995
36,1,3,0,2,6,1421008.23552659,3633339.54505641
19,2,0,0,0,2,1518701.49432227,3115557.01620895
38,0,3,2,0,5,1347231.64800945,1202426.98074158
25,6,2,0,6,14,2271818.66988701,7932565.56807892
10,0,2,2,7,11,2101019.15059515,7251555.07175029
37,1,1,0,3,5,1375525.53021133,3987749.40826371
31,5,1,1,7,14,2968918.7971641,7670220.33574139
38,1,1,1,7,10,1817794.14156318,6864080.59595849
19,0,0,1,5,6,2047692.96332076,4146212.75141063
20,2,2,2,0,6,1600345.10915736,5472711.5296845995
37,1,0,1,1,3,1436980.56628831,3824930.43469735
13,2,2,0,5,9,1603408.99354309,4972284.46884362
16,6,1,0,2,9,977588.0765998741,2811535.60623448
38,2,1,1,4,8,1838903.69684992,5765236.02246055
38,6,3,2,6,17,2139720.84606644,5082798.03969841
25,4,3,0,1,8,1777533.85057958,5618893.26075116
36,2,0,2,5,9,2258788.21078784,4706053.07215974
16,0,2,0,4,6,1220755.36992752,4592739.49190299
31,2,2,0,7,11,2237831.7599511,7209749.11250302
19,4,3,1,6,14,2835237.77563837,8298985.17345044
16,5,0,0,1,6,1775521.91788279,2724023.93820967
18,3,3,1,4,11,1820569.82018324,7555510.82275296
32,0,0,0,4,4,1618330.16998876,1212530.15613599
34,2,1,0,0,3,1251377.55694289,3274362.75167012
37,3,2,1,4,10,2084841.00291263,4821380.24802907
23,5,3,0,6,14,3092459.80865349,5467535.2177888
19,5,0,1,1,7,2162588.70878168,2428890.4571009
40,5,3,1,5,14,2541255.62695737,8047717.91384439
17,5,2,1,0,8,864149.9180021591,6103542.08909124
26,5,0,0,3,8,1797458.57353894,7646079.34108563
20,2,0,2,3,7,1314602.38932139,4449989.17927315
17,4,0,2,4,10,2217353.93804082,8064850.73531222
16,3,2,2,5,12,2487102.62063638,4993966.35961341
32,5,0,0,4,9,1657287.01906769,5929787.44607575
24,6,2,0,5,13,2614222.97984747,5875504.75181443
38,2,2,0,3,7,1681419.73668857,4206514.25850629
14,2,3,2,7,14,2514163.20391608,5137660.62128139
30,5,0,1,5,11,2761485.27773835,5330285.31431609
30,5,1,2,5,13,2298481.13121013,8390962.33942239
12,5,3,1,7,16,3083295.01242114,9759605.59309713
24,2,2,0,2,6,1608040.46452925,5639900.30694805
14,1,2,0,1,4,1686920.44313607,7548159.02970069
14,1,3,1,7,12,2547956.58366146,6138317.07249961
34,2,1,1,1,5,1613044.14410817,6100592.5047388
29,2,1,0,5,8,2086171.51024888,7681097.245641099
12,1,3,1,7,12,2594617.73242691,8928842.46558663
12,3,2,2,2,9,2312450.70706088,6345253.43731586
17,0,1,0,7,8,1640579.87108427,3133328.94178865
30,3,3,2,1,9,2313144.87407195,4198149.01327431
25,2,0,0,6,8,1463572.6126441,6190725.56968362
22,1,3,2,6,12,2157641.21382521,9016828.48315764
37,5,2,1,1,9,2099631.81697511,6621947.30018305
30,6,2,0,3,11,2615141.14310628,7683122.33181529
38,6,0,1,7,14,3293121.10844875,7984757.28204906
39,6,2,2,0,10,2453333.67597262,6817018.72564175
35,5,0,2,4,11,1966676.82574219,9677832.88268964
31,6,0,0,3,9,2057131.47752078,1819803.02658067
15,0,1,2,2,5,1543737.77948242,5815119.53650707
10,0,1,1,5,7,1220511.83193548,4884680.48509743
28,4,1,1,6,12,1634673.21599016,8458776.70223398
21,6,0,2,2,10,1958209.46374026,8551646.53779631
14,2,3,2,1,8,1896695.89571491,7209813.80964369
38,0,0,0,7,7,2175703.07255204,6954922.69155942
35,0,3,2,0,5,1580639.47151525,7549936.28465955
14,0,1,2,5,8,2063681.28621318,3926574.05633467
21,5,2,1,0,8,1748206.34920247,3069597.6348793
40,1,1,0,7,9,2692974.86094,7806532.16946896
27,3,2,2,4,11,2445538.83798284,6426888.75026219
28,2,2,0,3,7,1646738.74709025,6893499.20598647
16,2,1,0,4,7,1575194.83138047,4959323.86428407
32,0,1,0,7,8,1312922.58445753,6136306.96069873
17,6,1,0,3,10,2354690.28707855,4213736.34201972
16,4,1,2,3,10,1603855.65168471,4299763.85220341
29,3,3,0,1,7,1249157.50637166,4186489.65348044
21,0,3,0,5,8,1722878.30079109,5424412.27663936
18,1,3,2,3,9,2178095.5067027,5193100.58840187
13,6,1,2,7,16,2686326.45788804,6180625.89066174
37,1,2,0,3,6,1507242.15814807,4917282.46070837
28,2,3,0,5,10,1312266.12791799,8365626.91279942
27,1,1,0,1,3,1078260.04507327,4421264.12980539
40,5,2,2,5,14,2147311.65853851,8465140.70862085
15,5,2,1,6,14,2128669.39887623,6677380.57741441
14,6,1,1,2,10,2338991.52026907,4346566.35116578
19,0,0,0,1,1,1206856.07615887,1505703.3619108
26,1,0,2,6,9,1593359.09492785,3971263.76542267
22,0,2,0,3,5,1419862.741453,3973733.68361428
11,0,1,1,1,3,1299673.26521168,7009190.96906138
20,4,3,2,7,16,2831880.67601762,7251311.01770487
20,4,2,1,4,11,2310636.25171538,7274711.1277845
19,0,1,1,0,2,973102.717810152,4372665.34699941
13,6,2,2,5,15,2507142.26463804,5788288.04751576
38,6,1,0,7,14,2709235.89146686,8065899.91098193
34,1,1,0,2,4,1544347.43492325,2412690.63558114
24,5,0,0,1,6,1787366.80568008,5940651.49291932
20,4,1,0,3,8,1869786.89390484,4863849.569655
18,2,1,0,0,3,1649872.23935759,3538096.31607004
16,0,2,0,3,5,1285361.34005852,3190576.33967634
32,1,1,0,4,6,1584726.77603098,1558795.11192318
38,0,0,0,0,0,1216070.88922952,4006119.21548121
38,3,1,2,1,7,1618983.15824093,3127773.69583175
12,1,1,1,3,6,1091105.06056118,5454664.91937977
17,2,1,1,4,8,1526418.40791916,3378198.02910881
27,4,3,1,0,8,1713145.90913067,3504719.9233802003
23,3,3,0,2,8,2025289.24766111,7834768.88354393
33,5,3,2,4,14,3520129.2099498003,4339466.75284722
25,6,0,2,0,8,2052382.7837464001,6148200.34255256
12,4,1,1,0,6,1750140.84491912,3763021.15893997
10,2,0,1,2,5,1017129.85455133,6077182.01584666
31,2,0,0,5,7,2082994.89035416,4633035.09101756
11,0,2,1,6,9,2134095.7768391003,6198042.06888247
30,6,2,2,5,15,2226540.64025356,9394094.36949023
18,1,2,2,5,10,2150461.82216072,7156911.49695368
37,3,1,0,4,8,1330457.84322149,5402354.60519551
19,3,3,2,0,8,1896246.85399219,6040710.31488099
32,1,1,2,7,11,1348045.32132608,5040386.79414966
12,4,1,2,6,13,2461434.75535479,7729909.16657864
20,1,2,1,3,7,1577114.51566025,6521930.66149079
14,3,0,0,6,9,1679205.48744606,5916692.17008887
11,2,1,1,6,10,1593143.67770203,7373704.58904054
17,3,0,1,6,10,1619687.38635003,4105785.13234849
21,2,2,2,7,13,1588945.89095925,8024221.66529211
22,5,0,0,5,10,2185269.75079009,7612071.343862
25,3,1,2,7,13,2037805.47837208,4934392.84498307
18,5,3,1,5,14,2396492.50080187,8107965.36868787
17,6,0,1,4,11,2068180.59703173,8373350.42847376
24,4,1,2,7,14,2785294.24536638,8395205.86771161
34,4,2,1,1,8,1859830.02265667,3449213.55026237
17,5,2,0,0,7,1944428.03001929,1879624.42783701
21,4,3,0,7,14,3360353.40120491,7608877.69175332
31,4,1,2,7,14,2833863.01395145,6526128.87565162
29,3,0,0,0,3,1591245.09117116,1255725.3401056002
39,0,1,1,4,6,1915843.47463259,5820313.06334759
16,4,1,0,0,5,1446506.63831224,5263739.07965054
40,2,0,1,5,8,1796598.78321361,3590426.01069049
36,4,3,0,6,13,2105331.56118088,5082560.40885224
38,2,3,2,6,13,2678853.20819626,7495873.50970487
16,1,1,0,3,5,1548513.19557249,2272340.00772172
17,2,3,2,7,14,2090955.2832046002,6864763.3535585
39,2,3,1,2,8,1549174.59954952,3674517.60679157
23,0,0,1,6,7,1736487.89726474,4382460.56492049
28,3,3,1,4,11,1651489.16193971,5563733.04648624
31,4,1,0,6,11,2007428.53645342,4929023.9671511
31,1,1,0,1,3,760236.797916216,6485348.89011268
23,5,1,2,0,8,2175380.77924334,7964925.34246287
24,3,3,1,1,8,1770749.06077693,2824587.23704577
12,1,2,2,3,8,1744176.81262385,6683231.45472692
39,2,0,1,2,5,1633245.94946843,5231611.73812441
28,0,2,1,4,7,1609121.54376146,4504877.15319313
37,2,1,1,0,4,1171784.82754227,4928869.42809375
21,5,0,1,2,8,1589831.86030546,4769809.42520427
17,0,3,2,4,9,1761349.15521822,6214046.92754624
11,4,3,1,3,11,2236962.07145186,5693738.71959629
40,3,3,0,3,9,2112942.03672112,4974206.94972012
28,4,1,0,2,7,1941840.73946437,7495207.22605731
39,4,0,0,2,6,1709153.43583043,6540939.64590538
29,3,2,1,3,9,1862436.07300345,6075141.75892988
23,6,0,0,7,13,2590855.90997876,10630067.8712541
17,6,0,2,2,10,2208033.78272009,8678191.59879588
27,4,2,0,6,12,1874167.8062694,9106259.40132403
22,2,2,0,1,5,1525028.6688142999,5525525.62375379
28,3,2,1,1,7,1826023.68459432,5735995.16185392
33,5,1,2,2,10,1293566.38734612,5561171.50743993
17,1,2,0,4,7,1147412.74353191,3271075.18444341
30,4,0,0,4,8,1648660.83740111,823828.8997581679
21,0,1,0,6,7,1579236.36522909,4547088.99866753
35,4,2,1,2,9,1538896.65496231,4699598.38449536
16,6,3,1,1,11,1784135.8155194,5170703.79765067
39,3,2,0,4,9,1866601.40721261,4118787.2611808
35,6,3,1,3,13,2483353.68715848,7883149.15680408
14,4,2,0,6,12,2300055.07668568,7957285.77748517
10,5,1,2,2,10,2266674.37001201,4344167.60571965
37,6,3,1,3,13,1966200.7526708,9101362.32260802
31,4,1,1,3,9,1951184.04435504,6821228.76982105
39,5,3,2,7,17,2473206.8675839,8348556.25900334
27,5,2,0,5,12,2402248.98781489,4612850.35733087
12,3,0,2,6,11,2428279.53687854,5214249.70158594
30,1,2,1,1,5,2228662.59993431,1292277.32389978
37,3,3,1,5,12,2071094.02619437,5925840.23425403
38,3,2,0,1,6,1603074.17968103,5821065.67127013
23,1,2,0,3,6,934374.492287593,4756954.41631634
21,0,1,1,7,9,1990739.11532636,5859122.98900561
32,3,0,2,5,10,2291237.44010691,6828705.00581176
17,6,0,2,3,11,2837149.53043354,8169486.36509648
25,5,0,1,7,13,2733051.81557015,7993608.99492123
36,0,1,0,1,2,1307616.19042716,4181864.63766272
39,3,2,1,3,9,1819970.75965426,7851213.7805244
12,1,1,0,1,3,1416238.084194,3337496.21397941
20,0,2,0,4,6,2167993.47235078,3107783.79750207
29,6,1,0,2,9,1725988.49157333,5084307.69836068
40,5,1,1,3,10,1796069.87835482,5497670.98418273
29,3,0,0,5,8,1872848.64236311,5322903.92453378
10,6,1,1,3,11,2249443.52635298,4339752.93354925
17,6,2,1,2,11,2200681.42544791,5994285.68496371
11,1,0,0,0,1,1250668.23232801,3478927.29679276
12,2,0,1,5,8,1906203.66958414,5698062.55811948
24,0,0,0,6,6,1300527.34966278,8410508.31457601
17,1,0,0,6,7,1263258.48904729,4721915.983398001
13,3,2,1,3,9,1298831.22571145,7001009.64849424
12,1,2,0,5,8,1664332.10493213,4526280.72176368
40,0,1,2,1,4,1273734.34490864,4763634.88941826
21,1,0,1,7,9,1895146.80819004,4346867.33688063
35,6,1,1,7,15,1720371.29738396,3156548.98763564
18,6,1,0,5,12,2174954.53131939,10349198.7505649
17,5,1,2,2,10,1625705.77655099,5407473.38356294
22,3,0,0,5,8,1695808.59736559,8199173.532444
16,1,1,0,4,6,1562529.3944883002,1671328.4069965
28,4,1,2,0,7,1786802.99925128,5925194.28504633
21,6,2,2,3,13,2994587.74205809,7130396.52268592
27,1,1,1,1,4,1393000.98599514,4563654.18512127
29,3,2,0,1,6,1587727.92429969,3087071.78264063
20,1,2,0,6,9,2231113.58855885,6354755.68128556
15,4,1,0,0,5,1507222.94367062,2896672.97987419
17,3,2,2,5,12,2224180.95544159,9081434.52526972
12,0,3,0,3,6,1547799.54649265,4081210.23168577
39,5,3,0,7,15,2092688.90719638,9288879.86093991
25,3,3,2,6,14,2373780.90462255,6968075.33688924
13,5,2,0,5,12,1874838.48783412,4798736.80328979
20,2,0,1,4,7,2065197.92825019,4921991.56181147
40,1,3,0,1,5,1321613.0634489,4406493.26578699
29,1,2,0,7,10,2447104.54648981,5115809.39657426
10,2,0,2,7,11,1940087.8794464,5770977.07086373
23,3,1,2,2,8,2158948.08035837,7618259.00095112
29,6,0,1,1,8,1407628.3555533998,5876241.49758506
30,4,1,0,5,10,2149070.49375209,3390436.58960234
26,3,2,0,5,10,2340042.16111485,5448323.13060774
35,5,3,0,1,9,1810239.3154376,3865973.22292641
17,4,2,0,1,7,1351987.2070096,6330254.88572922
24,6,2,0,7,15,2765490.36428476,9547546.72241286
19,6,3,1,0,10,1794908.99035872,9958483.78943391
25,1,1,0,1,3,1298678.33076372,3700705.25191395
36,0,3,1,6,10,2054915.38013245,4708275.2705627
31,1,0,2,1,4,1202260.32622593,4814327.58202306
15,5,3,1,2,11,1993580.36627023,4859219.23627422
24,1,3,0,6,10,2007643.8767666,5001873.65211173
26,0,0,0,5,5,1796036.13248726,5886336.18933139
15,0,2,2,0,4,1302706.67297749,4496861.39826278
29,4,1,1,4,10,1433982.42784143,8923786.18199652
28,3,0,0,1,4,1211600.32040247,6575606.54408375
37,6,3,2,7,18,3002264.88556598,6753036.11289639
10,2,0,0,7,9,2380914.09947445,4303180.98727691
30,4,1,1,6,12,2390419.25579545,5289795.4384231
39,0,2,1,1,4,1432185.74630803,2454247.99592132
25,1,0,0,0,1,1356293.44787267,4418194.8882179
31,1,1,0,0,2,1431947.29665167,3008157.37544314
14,6,2,0,6,14,2504749.6792781004,9760742.64028145
39,4,1,0,1,6,1597991.79779257,3867831.50003691
15,2,1,2,2,7,1587830.29615322,4482933.61919179
39,5,1,2,3,11,2084513.03416364,3271185.31443941
23,0,1,1,6,8,1242783.35673545,6153349.44522088
21,3,3,2,7,15,2817757.53353259,6427247.87520122
38,5,2,1,6,14,2767457.93227951,4634255.06644359
14,0,3,1,7,11,1986072.479124,4347435.10856562
22,0,1,1,1,3,1256643.48172663,3011049.84880413
37,1,3,1,0,5,1489734.2229813,4904391.27115067
15,5,0,1,5,11,1977866.69572364,3798673.98241858
30,3,3,1,6,13,1915526.24320363,9414768.49682736
34,2,0,0,7,9,1480629.63260666,5681922.57213543
21,0,0,0,6,6,1380076.6623586,2412332.8505275003
30,2,0,2,2,6,1505106.48365468,3711905.0561980004
11,6,3,2,5,16,2783151.22721502,9091247.92509798
21,0,0,2,5,7,1734429.1267931,4037897.72538247
29,2,2,0,4,8,1583699.76777161,5787149.78198636
33,1,1,1,1,4,1090301.30984017,4800978.72743543
14,4,0,2,3,9,1815255.30146525,3821475.13205461
18,2,0,1,5,8,1788860.24095726,4073519.51151922
35,1,3,2,1,7,1823510.08558181,5440705.67454292
26,5,2,2,3,12,1988096.55730844,4814090.61040952
25,6,1,2,3,12,2231562.71318417,6914325.65364988
33,6,0,1,1,8,1586636.38582092,6825573.01401824
31,2,3,1,0,6,1923607.35896273,4207277.80544054
11,5,1,1,4,11,2493083.60873329,5640588.0229075
36,0,2,2,7,11,2056968.25969875,2371423.75086033
31,1,3,1,6,11,2508921.61585402,6736917.24140625
23,5,3,1,0,9,2095615.83467711,3888709.04634724
25,3,1,1,3,8,1607643.73913612,2785683.76929971
33,4,1,2,7,14,2261694.04904767,4264479.00942929
25,5,2,1,4,12,2174921.79441856,5468835.2666952
40,4,3,1,7,15,2539457.57668742,4515191.82221737
39,6,1,0,1,8,2363444.49309165,6938314.30005107
13,0,3,0,2,5,1353455.24191748,4550477.00296949
14,3,1,0,3,7,1256224.27860241,4439491.61569162
16,0,3,1,4,8,1719109.40383515,2648092.06586172
36,2,0,0,5,7,1843815.34742415,3992331.67193384
26,5,0,1,1,7,2113558.21321013,4418663.68170763
16,0,1,1,3,5,1606288.17987004,6655108.28724513
34,2,2,2,2,8,1204719.09587623,4554314.17440096
17,2,3,2,3,10,1497799.66533676,6539436.57709076
30,4,0,0,0,4,1323956.12537341,2610824.52427128
18,3,0,1,6,10,1409178.44281078,7250281.99046299
33,6,2,2,3,13,2273997.5609239,7623455.41487867
24,5,1,0,3,9,2103550.00646136,6324381.41122797
31,2,1,2,0,5,1219604.25837961,2450663.20775693
35,1,3,1,0,5,1498872.83404022,3839588.4225977995
35,2,3,2,7,14,2561196.57453022,5267617.89902175
18,1,1,0,4,6,1842767.17284284,4159442.8696558997
17,1,2,2,5,10,2222276.52494182,5861480.52291813
11,3,0,0,3,6,1684832.57723156,5536130.04199179
17,2,0,2,1,5,1544603.10341231,5491851.92684571
26,3,1,2,4,10,2084894.68788149,9470226.46518229
11,0,0,1,3,4,1462269.6691886003,5604771.72786589
10,1,2,0,7,10,1769972.39389136,4316390.33352781
26,4,3,0,3,10,2073126.19570206,7664217.92206919
15,0,2,0,2,4,1516133.37883269,3140346.60468565
22,2,0,2,7,11,2004974.19726486,9222831.07842727
35,2,1,1,7,11,1894425.77943428,7932262.65416011
30,5,1,2,1,9,2438138.74211508,5964230.92959688
38,1,1,0,6,8,1400640.80982637,5107961.0313435
23,4,2,1,4,11,1930334.07857182,2644328.72268252
23,6,0,0,5,11,2650685.01774612,3578422.61100523
28,6,0,2,7,15,3243419.76098669,12182375.4802613
29,5,1,1,3,10,1719536.49185181,7591478.52710747
31,5,2,2,4,13,1846498.67096316,8602681.87205563
36,6,1,2,7,16,2688150.07367329,10815607.974940801
40,1,0,0,2,3,1210644.77804444,4034981.18877067
40,2,0,2,3,7,1787597.90906473,5794730.47402659
19,0,1,0,1,2,1343680.49295027,4359715.80645576
15,0,3,2,4,9,1934629.4883673,6033905.80077725
25,1,2,1,6,10,1416170.71684527,3594554.60407843
20,2,3,2,5,12,2392852.27866937,4124350.88422854
11,5,3,2,1,11,2090503.13760045,3445009.33229807
34,0,0,1,4,5,1391941.57287197,2430282.95521579
14,0,3,1,6,10,1523064.91882949,5472723.21707557
21,4,1,1,2,8,1664348.85670604,6317369.3449424
14,1,1,1,0,3,1107923.73406492,4633964.86914814
40,4,2,0,3,9,1404811.59197267,7218030.26441403
38,4,3,2,0,9,1656508.58705416,7083122.55861733
33,6,2,1,2,11,2541409.54783885,5092475.10466716
16,2,0,0,3,5,1611059.57185369,3190929.37677343
34,4,0,0,0,4,1564714.64214286,1761505.92939905
18,4,1,0,0,5,1427986.33144306,4736230.79441083
37,6,3,2,7,18,1665556.83535807,6325155.10432969
16,1,1,2,7,11,1185039.97154364,8071445.34245439
16,3,2,2,7,14,1188615.09985045,7801923.77315415
31,0,1,2,7,10,2521848.22378542,7520473.37698794
27,1,3,1,4,9,2084605.14408882,3706762.83642633
11,5,1,1,7,14,2262873.47600563,11596740.0520666
18,6,1,0,2,9,2010686.50735235,5512500.14006323
36,4,2,1,7,14,2062048.04883527,6756211.41730308
15,1,3,0,5,9,1797313.765816,6262823.6837460995
29,5,2,0,1,8,2242836.47509121,4693534.03065362
22,5,2,1,1,9,1944770.94239137,5686543.44610397
15,0,1,2,0,3,1518304.48343819,4376872.254001101
11,3,2,0,4,9,1805718.63073056,6704635.9529234
13,2,0,1,3,6,1090670.17059661,4504453.34175476
20,0,0,2,2,4,1326995.36854158,5648569.19059011
25,3,2,1,3,9,1742060.3538308998,7992925.94040542
12,6,1,1,1,9,1461047.00735941,7006956.58248418
22,2,1,2,7,12,1394193.30269176,6082994.92065986
32,2,2,0,4,8,1924409.25098826,8106773.69597847
36,3,2,1,0,6,1936815.37666157,5516754.46239697
31,4,3,0,7,14,2600129.27769087,11712072.4094619
33,0,1,1,4,6,1648457.44347402,2683537.93218177
27,4,3,1,3,11,1917217.4877766003,7815828.48992304
12,0,3,0,5,8,1651340.46105279,6613276.12692755
11,0,2,0,5,7,2155498.34075959,5576211.19427984
21,6,0,0,3,9,1484844.05271507,5412908.64394884
32,6,2,1,3,12,2406451.89296477,6774315.75170865
24,6,0,2,6,14,2980060.13591639,8089705.69759764
18,3,2,0,2,7,2205133.01772316,3685286.2013761
18,4,0,2,2,8,1577354.93297084,4281204.63182581
19,5,2,1,6,14,2695105.58753794,8448218.63623569
16,6,0,0,5,11,1881243.84740496,7407465.48423808
36,1,3,0,3,7,1134989.57758576,5831485.961019901
18,1,2,1,5,9,1383140.84538305,6924471.91465373
15,5,3,2,1,11,2525871.08663971,5121976.25482838
38,3,2,0,5,10,2456161.95654574,2747754.37734318
26,5,2,1,6,14,2840085.30918894,8690507.78345923
34,3,1,2,6,12,2326308.49499657,7218396.073379901
37,1,0,0,2,3,1258489.59446303,4129009.24839835
38,5,0,0,3,8,2286070.60643293,4947339.69340481
10,6,0,0,0,6,1968697.50349255,5747744.34555661
34,6,3,1,5,15,3144623.6574273,12560084.616613198
27,2,3,0,6,11,2198241.09433821,7600437.69089694
36,6,3,0,1,10,2462763.35151805,6421455.87208533
20,3,3,1,6,13,1542821.13598486,5389178.85100498
15,2,3,2,1,8,1718048.2059003003,1955456.38964366
17,5,2,2,5,14,2203589.30863184,7592445.14707291
39,6,3,2,3,14,1699461.34252012,8046470.213137201
21,3,3,0,4,10,2018138.91325701,7786985.04854432
39,3,1,0,5,9,2083929.03426035,7397798.99336402
25,4,3,1,0,8,2034037.13856463,4912198.5510844
19,4,1,0,3,8,1601296.42358941,10196181.5963386
10,5,2,2,6,15,2621078.79847314,7711086.13138981
39,1,3,1,4,9,1646632.90920188,4731488.08451117
32,3,1,0,1,5,1581055.56610491,7721296.51257727
11,4,0,1,0,5,1339242.84189286,3883844.35912034
24,2,2,1,2,7,2056600.04396739,5091661.77503802
31,6,0,1,5,12,2091063.38256533,4090417.70160445
32,6,2,0,7,15,2586857.00689369,9377060.31319738
11,4,1,0,0,5,1618099.8286315,4188865.01299392
27,5,1,2,4,12,1807756.37192107,9746564.94855219
38,2,3,0,7,12,2360481.91318945,3273744.09748445
20,5,1,2,5,13,2275353.61842448,7785701.45829744
11,3,2,0,3,8,1178828.59836571,3037591.32321594
21,5,3,0,7,15,2823435.17910249,4430162.69303613
11,3,2,2,1,8,1471027.43267964,5378746.48741469
31,0,1,0,5,6,1396427.22497865,7370554.80136235
32,0,0,0,0,0,1181934.84419878,3392430.31644126
32,2,0,0,7,9,1933549.49513561,1854657.64635588
10,4,1,0,7,12,2774154.33076563,6119471.29961604
16,0,1,2,0,3,1358072.65783223,4616806.56204291
27,6,1,2,1,10,2081954.99145211,8441273.000815801
17,2,1,1,2,6,1581692.01389796,5754523.04467175
33,6,0,1,7,14,1813459.54647254,5800570.77404316
10,1,2,2,4,9,1611511.20297815,6025279.9766068
21,1,2,2,3,8,1892414.26160931,4136664.22721978
11,4,3,1,5,13,1483348.86721944,5213938.43399532
26,0,3,1,6,10,1823492.69813084,4999965.09017252
39,0,3,1,5,9,1562709.17623793,7461570.64140427
16,6,1,2,2,11,1954885.19588763,7596246.36101121
34,3,0,0,6,9,2486173.94922265,3701369.8162285006
33,4,2,0,3,9,1842614.69997231,5392598.63751304
11,4,1,0,1,6,1459354.24579673,4446378.86982871
15,5,3,0,4,12,2199615.18524637,6480286.02020558
11,4,3,1,3,11,2268754.5494419998,6929651.02233065
18,4,1,1,1,7,1467982.14042983,5492721.44510349
30,1,2,1,6,10,2167323.80418795,8898381.43868727
37,1,3,2,0,6,1444199.30559108,2067113.19401493
37,2,3,0,3,8,2067320.13203705,4863151.87109959
15,5,1,0,4,10,1969601.56924497,4651233.90515287
12,2,2,2,2,8,1992261.28953694,3882113.02937531
29,1,1,2,1,5,1737146.87951705,6613291.79525533
32,4,0,0,5,9,1872270.25693027,3245112.43904642
33,6,0,2,1,9,1977160.80699166,6174818.24598677
26,6,0,2,3,11,1637724.01371918,5466271.02637023
20,0,3,1,6,10,1757847.54929242,7576433.306144
11,5,1,0,0,6,1592139.28578048,6431286.48873316
12,1,2,1,7,11,1912068.61072781,9409661.30571849
11,1,2,0,1,4,1301379.12895639,5129075.06109115
34,5,1,0,4,10,1771531.77942783,6635030.57038581
23,0,3,1,6,10,2320059.55101475,6411520.28464061
26,2,1,2,4,9,1577082.62963494,5518575.48770891
31,2,1,1,1,5,1646738.70446693,6197072.66659395
36,6,3,1,7,17,3555633.79137669,6503354.06852552
13,3,0,2,1,6,1326362.02631204,2984450.6017738
22,1,0,1,0,2,1331879.90471866,4335943.02898175
34,1,1,1,4,7,1755901.9163455002,3045925.61220684
12,3,2,1,5,11,1949262.60393034,7361137.11679214
39,3,1,1,3,8,2015375.32607177,4146021.3298037993
28,1,0,1,6,8,1775205.46717985,5059801.90642315
23,1,3,2,4,10,2468673.43523375,6844692.20775902
18,0,0,0,7,7,1711640.14615758,5924473.13904335
34,3,0,0,2,5,1790310.38021424,5028347.0418522
12,2,1,2,7,12,2083361.01660671,5523192.93371859
40,0,1,2,5,8,1975183.46527271,6720633.52512166
37,3,2,1,0,6,1675843.91419781,2810942.01201068
20,5,0,2,6,13,2218059.75115285,2376842.67587693
35,4,0,0,1,5,1779280.27706589,6400424.36589059
28,3,2,2,0,7,881852.2151402809,3161990.61603439
28,6,3,1,6,16,3000168.15066323,3500831.46078984
26,0,3,2,5,10,1878675.4394948003,6939223.66915623
23,4,2,1,1,8,2093855.89078527,6775321.97161462
38,3,1,2,0,6,1612248.51883648,5348582.09816364
32,4,2,0,6,12,1550578.59718571,7179653.18052743
29,0,0,2,0,2,1342264.94081633,4706004.96606301
38,2,2,0,5,9,1702169.66821628,5950869.7600628
23,2,1,1,3,7,1791240.59026759,6270654.01458443
13,3,2,0,1,6,1398156.04224138,4281525.29234746
24,5,3,0,0,8,2136923.45987201,5646388.35705992
11,0,2,1,6,9,1939715.97806359,7738865.11799001
23,1,1,0,7,9,1562252.54214446,7280121.83682572
18,1,3,1,1,6,1697813.9750718,6433635.20011525
20,2,3,0,6,11,1762047.05095516,5642007.90925779
14,0,0,0,2,2,750701.541844062,6180575.74610901
28,1,0,2,0,3,1302941.38974035,4524753.29556771
22,6,0,2,4,12,1813279.17930793,6704050.69124447
16,5,2,1,2,10,2576592.67623918,6649657.16610341
22,4,0,1,0,5,1894195.16539126,3857830.71297617
38,0,1,2,6,9,2282775.24406497,7931922.69085418
16,0,3,0,5,8,1590412.90297323,7325007.99227593
37,5,3,1,4,13,2256650.17256014,7196011.65429016
22,1,0,2,5,8,1912479.49941222,4377500.26282337
27,5,0,1,4,10,1638608.61679879,5187467.94287654
35,3,1,2,2,8,1807849.90014512,6211401.38914341
22,3,1,0,3,7,1187486.49789917,4009903.99567712
35,4,1,1,5,11,1971314.54180182,6860557.19165584
30,3,1,2,0,6,1221657.6424314,3246850.91143584
22,4,2,0,0,6,1474614.34726469,2418557.53314204
35,2,1,1,5,9,1779114.1094275,7648769.67816481
11,4,0,2,2,8,2227138.66808907,6576980.32447826
22,3,1,1,1,6,1661972.93808595,4828044.68319794
30,5,0,2,4,11,1847207.79790741,5591109.96897429
31,4,0,0,6,10,2194028.25933863,6166868.45033671
14,5,1,0,6,12,1687938.20994842,6393461.72881878
36,2,0,2,2,6,1878483.08654549,4968053.56268749
32,2,2,1,0,5,1569500.61207216,4154337.70284503
16,5,3,0,2,10,2022762.69005974,4916451.57532402
40,3,2,0,0,5,1694342.27762363,5383986.05593603
28,0,1,0,2,3,1341547.55867723,2696885.96272612
11,5,2,2,2,11,1830310.30110679,8400568.12225605
23,6,1,2,2,11,1976317.79490863,4821253.82643779
27,4,0,2,2,8,2478189.67120026,6695245.04206251
34,5,3,0,0,8,1472659.6159318998,3503429.73026562
37,5,3,0,0,8,1803369.2520515,6743785.0105165
17,2,3,1,6,12,2278631.48053531,7868365.68881167
33,6,1,2,3,12,2263155.23024326,5480999.36222508
40,5,1,0,3,9,2309935.15284303,5446430.11443327
25,0,1,1,7,9,1574733.80559174,5600612.34258809
25,5,3,2,2,12,2137461.09285529,6954588.46340873
18,3,2,2,3,10,1936005.55770188,4194395.14788963
15,2,1,0,0,3,1163709.84067,4700895.54912918
13,6,0,0,3,9,1633630.94928517,3097867.32507107
12,0,3,1,0,4,1741232.12920666,3675935.40964418
39,4,1,2,2,9,2451920.82736242,5402572.79432756
35,3,0,2,6,11,2106052.37502121,5236408.36786264
31,3,0,1,2,6,1721018.47441527,5369362.89666893
28,6,2,0,4,12,2148406.92299968,2659925.60997393
15,3,2,0,2,7,1848365.2918305001,3564813.80153247
30,0,3,2,7,12,2219627.35282444,4376804.89458877
23,1,1,1,2,5,1813509.8499681,4337598.48255934
20,3,1,1,0,5,1304766.44790644,6759099.11088633
24,4,0,1,0,5,1349166.44832952,2691997.78859745
31,4,1,2,4,11,2161991.26649985,6751206.47174794
37,4,1,2,2,9,1735689.00310316,4979067.36033935
12,0,3,0,6,9,2142949.68482548,3721966.80228032
32,6,0,1,7,14,1761458.91908331,12237673.4916601
36,5,0,0,5,10,1825415.01148303,8013248.57199016
11,4,2,0,5,11,1867949.38979218,5466032.45041352
40,2,2,1,1,6,1466602.31013462,2510800.85422672
23,4,2,2,7,15,2497325.46765068,10268999.7647985
38,4,0,0,4,8,1790917.26743707,5142474.78173891
25,4,2,2,7,15,1535669.85039282,7675847.31702054
32,5,3,2,4,14,2809266.23657145,7502157.23526383
26,0,2,2,2,6,1799764.37293633,3271150.90730742
34,1,3,0,4,8,1903352.10229071,7701280.54833649
27,0,1,2,0,3,1020949.36832161,3732223.11516351
12,4,1,0,2,7,1596509.86257292,6636978.28303382
30,2,0,0,3,5,1468517.49565521,4336406.46623474
17,4,0,1,4,9,1712380.40991148,6196320.71450754
23,6,0,0,0,6,1679534.51944558,5443479.94962424
10,3,2,0,0,5,1539369.4639596,3964380.31532453
27,6,1,2,0,9,1910121.01716045,7737881.49301044
38,6,3,2,0,11,1765001.94235603,5067514.87658244
22,5,0,0,2,7,1322383.93081591,4177277.75091179
26,1,1,2,1,5,1547962.85837354,5955498.84856052
36,3,0,0,0,3,1513472.13490276,563892.3636795001
38,3,3,1,7,14,2653901.87312779,5893387.67604999
14,4,3,1,0,8,2153333.9288363997,8528565.90629676
35,6,2,1,3,12,1918171.5766207,4852413.4614287
25,2,1,0,6,9,1772825.11774035,4137547.65954308
25,5,0,0,3,8,1823519.00438103,3870643.32116247
39,6,0,0,3,9,1523889.40887627,4541584.56121712
14,2,1,1,7,11,2319285.59046088,6455486.82939217
24,2,2,0,0,4,1603234.36327266,3374113.27644578
27,0,2,2,4,8,2009220.72698568,6853165.84383475
40,3,3,0,5,11,3016139.92542163,2113648.3095101
40,1,1,2,6,10,2089127.14397373,4678727.58618974
38,2,0,1,6,9,2076933.55795591,6643282.76413663
22,1,0,2,2,5,1565856.80371542,5667359.02778127
37,3,3,2,0,8,1987476.63162099,3327240.98730705
14,2,2,0,2,6,1530279.50926513,8175836.3695399
12,5,2,2,6,15,2168468.1438732,10790352.181521699
18,4,1,2,7,14,1980235.09600236,8039182.78152537
22,0,0,0,3,3,1515472.46095422,1770136.6975455002
33,3,1,1,5,10,1960741.44941178,8157408.61113628
30,0,3,2,5,10,1645041.28435309,7612034.27813443
19,2,2,1,0,5,1631489.34407848,1605478.23366903
29,6,1,0,1,8,2086471.92349458,5612748.74498293
22,0,2,2,7,11,2294371.1417223,8719601.11160003
33,0,3,2,1,6,1336354.77107792,6183122.34110158
26,5,2,2,0,9,1574282.52176452,3999407.6023084
11,1,2,2,0,5,1377447.70777801,2995967.03972369
28,6,1,1,0,8,1955278.36545355,1763633.7025681
36,1,2,2,4,9,2421723.56905332,7718885.97612298
28,2,3,2,6,13,1878070.91440122,7088350.04992893
12,6,3,2,1,12,1778974.23640037,5151114.24268806
36,0,0,2,2,4,1912156.96290215,2659501.6105739
31,2,2,1,7,12,2205093.78536009,7638573.03432291
30,2,1,1,6,10,2007547.28595098,6410069.12433258
22,3,2,0,4,9,1900722.25382497,4374390.77599744
16,0,1,1,1,3,1521695.87591542,3993086.73653743
10,5,3,2,5,15,2192154.27734871,7642447.18393545
15,3,1,2,1,7,1987251.76179061,6496465.11129334
29,5,0,2,6,13,3125256.2655932005,5384425.81721918
23,4,1,1,4,10,2406470.02220517,3433704.12610889
11,2,2,2,7,13,2060084.98690005,4059287.04271708
37,4,2,2,4,12,1841735.73165641,8481241.16082665
40,4,0,2,2,8,1533799.23379079,2912934.53445001
34,5,0,2,2,9,1801976.54118904,2821365.44523753
10,2,1,1,3,7,1749665.40287,3222750.13842525
18,0,1,2,1,4,1082528.46410001,5375131.8935455
19,3,2,2,2,9,2083029.18281256,6973107.79126983
36,2,0,0,2,4,1543353.09229877,5245046.97887418
35,0,3,2,7,12,2322762.14262355,6648545.32692379
23,2,0,0,7,9,1836444.51547828,3991460.26128451
33,3,0,2,2,7,1738238.75722989,6604722.77199712
13,6,2,1,5,14,2260888.7237365004,6570626.90074642
31,5,3,2,7,17,3155560.81335831,6850885.36354828
22,3,0,0,2,5,1676052.74739275,4651361.08411654
36,2,0,1,6,9,1730324.42399712,4530379.70223625
19,2,1,2,5,10,2078139.86527589,6326635.42867371
27,3,0,2,2,7,1872177.52368126,2916978.60292675
37,1,3,0,3,7,1245293.78549165,4312680.5972496
10,0,3,2,3,8,1845228.43766128,6299328.78462098
32,6,3,0,3,12,2617607.23541268,8564221.59025426
21,1,0,1,1,3,1499421.2326148,3291680.96041634
30,2,0,1,7,10,1871057.45949609,7926353.48054222
35,6,0,0,0,6,1485937.35078366,4011030.39529035
16,4,3,2,1,10,2099066.72870183,7847714.59706213
30,6,1,2,1,10,1969315.7516148998,5646846.15563725
30,5,3,1,0,9,1559312.43721781,2212143.9374015
28,1,3,1,3,8,1489014.92823898,5727331.89475493
10,6,2,2,1,11,2413881.22936774,2809098.38350694
37,2,0,1,1,4,1526454.76653455,6912288.57114578
13,5,0,2,0,7,1680927.11124383,4772918.66843425
24,1,0,1,0,2,1280599.75407411,3382056.19917195
32,2,3,0,6,11,2102675.21331082,6416707.33962412
19,1,0,0,5,6,2179169.32186336,3823468.33559395
23,5,0,1,2,8,1635068.45670007,5635132.099233401
16,0,3,1,3,7,2190991.54434918,6992111.94274603
10,4,3,1,3,11,2281575.12291692,7031194.990281401
14,5,0,2,1,8,2049065.64356407,4250519.76234789
38,2,1,1,6,10,1805010.34449583,8961615.22876658
37,6,1,1,1,9,2139453.35138428,6907438.96798729
12,2,2,1,7,12,1682000.0573866998,4659324.74914586
37,2,1,1,4,8,2109335.6735837,6247949.41873389
36,0,3,2,1,6,1211948.95154625,3619987.63275831
13,4,3,1,3,11,2376088.38454984,6206188.4297972
34,3,2,1,2,8,1275248.78499359,3885217.2238591
10,5,1,2,0,8,1699630.16785664,5861004.9484641
10,0,1,2,4,7,1518609.99705114,5696628.98106707
32,0,0,2,7,9,1997219.42113275,6311981.45952802
20,3,0,0,1,4,1534956.26049747,2663839.45999274
19,4,0,1,3,8,2157802.62227993,3761820.65622309
14,3,1,0,7,11,2921942.29665814,3890931.51615067
27,3,3,2,3,11,2204492.65650831,7327061.38676585
17,4,0,2,2,8,2289985.02643301,3622471.00621525
30,6,2,0,5,13,2126428.09717565,7035957.75876617
20,4,3,0,2,9,1731540.90907981,6899866.87099313
31,2,3,0,2,7,1592339.9188255,7320558.14483901
29,6,1,1,2,10,2129622.7463662,8371875.54191534
15,0,3,0,6,9,1922941.19801532,6220661.63559528
19,2,3,1,2,8,1438110.36925996,6683862.92778771
33,2,1,1,3,7,1874436.9873993,3297958.9080855
36,0,1,2,0,3,1623892.08010262,2842717.7844477003
14,2,2,1,7,12,2528719.12528853,5822204.82174041
13,0,3,0,4,7,1738413.7620506,6601906.86202757
27,4,1,2,4,11,2132493.50810446,6386994.70365845
39,4,3,1,3,11,2065118.36765275,3580667.61091708
14,5,1,2,3,11,2292148.27442251,6243047.97096298
17,5,0,1,2,8,2079733.63150137,6126597.40543687
29,6,3,0,0,9,1489286.22113438,3810084.39452389
10,1,0,0,7,8,2008621.07740866,6155884.74684173
12,0,3,0,1,4,1110032.18903176,2466271.34050763
15,2,3,1,6,12,2293727.74222115,5196828.44214431
23,2,2,0,7,11,2356998.35947758,8507602.09274708
16,0,2,2,4,8,2011739.46334821,6331786.5423655
27,6,1,0,7,14,2813375.05645909,5859317.14871232
10,1,1,2,6,10,2386125.06693682,8707538.28670294
12,6,3,0,3,12,2344888.97130219,3963737.23264647
34,1,0,2,3,6,1781726.90937031,4794387.9825810995
10,6,2,0,4,12,1788029.49371621,8926949.359593302
34,0,1,1,2,4,1547104.81686515,3893136.47446381
18,3,0,2,0,5,1750372.05563603,2902072.1097486
16,0,3,1,7,11,1862427.62095649,7944625.32166351
30,2,2,1,3,8,1426176.77667743,4930524.47963973
33,5,0,0,1,6,1484503.08263548,4010831.23475471
10,0,1,2,6,9,1722989.14386023,454727.745185695
39,6,1,2,7,16,2157901.90371639,6176249.37946376
19,2,1,2,7,12,2369141.36094832,8024155.76499716
23,5,0,0,1,6,1540280.03621474,6745109.60600909
26,1,1,2,3,7,1302933.62081956,3401658.1916777003
33,5,0,2,7,14,2407924.01348545,10417335.1796593
17,5,0,2,6,13,2246547.77272809,6920792.87793132
24,0,0,2,5,7,1604586.4257326,4858923.27807315
20,5,1,2,1,9,2110067.13160285,6631098.71262412
28,3,0,0,0,3,1373810.59506764,4794465.08747078
23,3,3,2,6,14,2779229.73104627,9132347.99515457
25,5,2,2,7,16,2453236.96900414,6359189.39064398
11,4,0,0,5,9,2175410.33086599,5509261.29020738
38,5,0,2,1,8,1934464.96391146,7061908.24985152
29,0,3,1,7,11,2333518.26408721,6153585.144538401
35,4,2,2,6,14,2186392.2034971,4069857.22503513
32,6,1,0,1,8,1458954.11382148,5068032.86841615
28,6,1,1,2,10,1787199.44090541,5257592.09098949
14,0,3,0,2,5,1511023.19582935,5818103.66986804
25,2,1,2,0,5,1866104.47006913,1753944.66473532
38,0,0,0,5,5,1580016.56798725,6411632.64459284
29,4,3,1,0,8,1827231.79074318,5620497.17960775
29,4,1,1,3,9,1204593.56163838,4595736.71598046
12,2,1,0,6,9,1994657.96798663,4622438.55470834
39,1,0,0,7,8,1173622.13062091,3445927.42499484
24,4,1,2,7,14,2293526.29053695,9096501.26468596
21,3,0,2,0,5,1399019.33072991,5405802.38518574
32,5,2,1,0,8,1932191.6837753002,8571648.46228323
18,3,0,0,3,6,1315207.93034707,454900.208006696
19,6,1,2,1,10,1472087.26370642,8491392.22325114
17,4,2,0,0,6,1901708.99011191,4705515.57947931
33,6,0,2,0,8,1799957.77279009,7326650.16010682
28,4,2,0,6,12,1842006.85476119,7179439.69126735
37,3,1,1,0,5,1262376.35561202,3748353.86940335
30,2,0,2,3,7,975262.5889866891,6689327.89015261
16,3,0,0,7,10,1724932.4860744,7787047.48766047
10,2,1,0,7,10,2343999.51922419,7659602.13977585
37,4,1,0,7,12,2068333.85333101,8134503.78986184
22,6,1,2,1,10,2196548.33182777,6305409.25896967
16,2,3,0,3,8,1942397.39790542,5057604.44115422
34,2,3,2,4,11,2727011.75671496,5322085.00038071
17,6,0,1,5,12,1386984.79890628,7432810.63641693
27,6,0,0,4,10,2288214.96508844,11535666.3612657
33,4,2,0,1,7,1933969.71461118,5952452.28677747
37,2,2,1,3,8,1896019.39378982,6489735.39715372
14,5,1,2,7,15,2410726.97888653,4720515.26417072
39,6,2,1,7,16,2376754.06083671,7441244.11999297
20,5,0,0,1,6,1127500.41139801,7199234.39648807
37,5,3,1,1,10,2062514.4145429002,5854726.76459174
25,2,3,0,2,7,2194133.17935552,7710294.66202742
19,3,2,2,0,7,1910351.5878759997,4938940.74261563
40,5,0,1,3,9,1634731.92779713,5835996.84351099
25,1,0,1,4,6,1296282.00352461,4566590.43494103
36,4,3,1,4,12,2662851.3300635,6713547.77603403
12,1,1,0,7,9,2200970.49116214,5885831.72653467
34,5,1,2,3,11,2202019.20209753,4953188.14840656
29,2,0,0,5,7,1550850.00041706,5021592.10480307
25,4,0,1,3,8,1879989.71800729,4744476.68232136
17,0,3,2,4,9,1611313.44017327,5966273.62544143
32,0,0,0,5,5,1574486.73979331,4336834.65127748
16,0,2,0,2,4,1189133.45492306,2789074.98083618
17,0,0,1,5,6,1050376.19072472,6650109.89304482
27,3,0,2,2,7,1693778.3617888,5465810.31763102
40,3,1,1,3,8,1870641.98829637,5770072.77503275
24,0,3,1,4,8,1849998.15924105,6435324.79943796
28,1,2,0,6,9,2074091.84057451,5231187.70153275
36,4,0,0,3,7,2234032.03407839,3795174.89669259
16,0,0,1,3,4,1708436.63852983,4718509.79578404
10,4,0,2,3,9,1952266.9251476002,7667102.30221756
21,3,3,0,7,13,2256534.36718395,9650139.97988129
34,2,3,2,1,8,1655609.01136825,8261794.90113855
38,6,0,0,2,8,1805315.60330828,1370867.98731591
28,2,0,2,7,11,1642943.14124362,6866288.08892062
25,6,2,2,1,11,2138419.41897269,5407253.96406595
31,2,1,1,3,7,1467523.31005703,5781002.03654099
30,0,0,2,3,5,1535255.7315858,2982134.28596532
15,6,0,0,2,8,1745868.36589494,4898411.14396362
36,0,2,1,3,6,1609730.46700702,3991729.29057176
36,5,1,2,6,14,3144675.2376698996,7180183.64127195
37,0,1,1,2,4,1744154.29391449,3068950.15561737
39,5,1,0,5,11,2184448.55941477,6270765.57670243
29,1,1,2,4,8,1813389.52605756,5229877.47896139
40,0,3,1,3,7,1551704.58627116,5928049.12770257
28,1,0,2,5,8,1758440.4558398998,6028561.23557614
13,0,2,2,1,5,1293901.0246176,2626618.0192628996
32,5,1,1,3,10,2413824.66187971,8389478.56199027
29,2,2,1,5,10,2498256.96806968,4545335.86949377
26,2,1,1,3,7,1434584.03898767,4211156.19914308
33,1,0,1,0,2,1321702.70267384,3988287.35806591
16,5,3,2,0,10,1887049.09153932,3055274.06686778
33,4,2,2,1,9,1869080.4115475,7431265.66710879
10,5,0,2,4,11,2038745.98301238,5847762.7061561
22,1,0,1,7,9,2069336.0725971002,5925149.43860043
25,3,3,1,3,10,2689504.23579518,7684826.99993537
17,4,2,0,3,9,2635787.88621989,9768166.09797902
35,1,1,2,7,11,1534042.84088467,3329831.58344837
33,2,0,1,7,10,2393093.58219078,4246493.93792175
33,0,3,1,6,10,2531254.52658309,6937720.61122132
36,5,1,1,5,12,2440083.78345034,7983065.63018183
23,5,0,1,0,6,1665296.40014864,4866036.42198223
29,5,0,0,4,9,1985325.79282384,6064803.11237959
18,3,0,2,1,6,1390583.80003845,2611646.0895727
12,2,0,2,3,7,1420182.33342947,6267970.69676495
28,4,3,1,7,15,2989439.0577474,7662220.17098578
17,6,3,1,5,15,2582620.59310499,7593092.26467086
17,0,3,0,5,8,1831104.85693118,6754801.8165393
26,4,1,1,5,11,1668095.77860704,6151022.36586978
31,6,0,2,0,8,1821948.74308365,7398001.39719796
40,5,0,0,0,5,1714819.19131894,4800579.01900206
18,5,2,2,1,10,1784746.01881988,5605178.47508984
31,6,3,2,5,16,3451261.06874162,7465632.99029006
15,6,0,1,3,10,2178013.87580883,7349458.22350533
19,4,2,2,7,15,2452625.6476024,8866588.98764101
30,5,2,0,6,13,2289150.21046423,8822395.3053431
30,6,1,1,3,11,1904607.31519678,6707095.21427293
15,5,1,1,2,9,1911872.60396143,5629431.14715877
13,0,2,2,1,5,1929567.14604361,4494554.10870246
27,3,3,2,7,15,2603653.26518388,5646517.59296186
39,1,1,2,0,4,1506200.81166371,6330850.82947861
21,5,3,0,7,15,2687381.69105204,5715805.87519564
31,0,2,1,1,4,1325980.15313621,6415461.01119808
14,4,1,2,6,13,1896963.63296113,7265756.04025628
13,6,1,0,7,14,1796524.83763661,8142680.19118377
21,4,0,2,7,13,2100570.63403061,4868385.80578204
10,2,0,2,6,10,2103216.24656621,8527320.06773749
32,6,3,0,6,15,2586172.58970807,7441628.02480685
36,4,0,2,4,10,2339984.75304797,3583080.60853338
10,2,2,0,2,6,1199722.46057613,6385344.84732602
34,2,2,2,5,11,1381461.99999092,4749980.67031701
36,3,1,1,2,7,1976872.031373,1446567.43916709
20,5,2,1,1,9,1611094.95169672,4562918.05754844
27,4,0,0,1,5,1474880.58788673,4466384.66515866
33,1,2,1,1,5,1448129.62997072,4325772.61243225
21,0,0,1,0,1,994314.986948929,3379721.76379781
32,2,1,2,2,7,1649821.64822765,4750473.79753699
36,2,1,2,2,7,1031162.30904919,4891109.00238796
25,4,1,1,4,10,1877474.80231337,8005695.97715848
26,6,0,2,0,8,1962019.77988716,6853428.40066465
25,4,0,2,5,11,3061689.35632608,9306370.85706022
22,4,0,2,3,9,1774060.37244968,6541440.50233933
21,4,0,0,4,8,2128441.33601355,7591087.3670850005
16,4,0,0,1,5,1554638.28136385,3356798.99847293
18,3,0,1,6,10,2114435.54951677,5064607.43130699
26,0,2,2,1,5,1084544.38159821,6050106.07546263
23,0,3,0,2,5,1301433.93991693,4558079.17700272
15,2,1,1,3,7,1810829.75403561,5138692.92777183
16,0,3,0,1,4,1532218.76368304,2193915.4002741002
40,5,1,2,0,8,1720798.45080753,4601212.03648161
21,0,2,1,2,5,1933307.13591979,7060882.77480461
28,2,3,1,3,9,1910398.6786426997,8473753.74638968
29,2,3,1,0,6,1661131.35394461,5250973.94238739
24,5,2,1,6,14,2762549.91558815,6207407.81670238
29,5,2,0,7,14,1895106.5200119,7391365.02871348
21,1,2,2,0,5,1239050.74397907,6328748.89233145
26,5,0,2,5,12,2749478.0752985002,6677941.44249341
39,3,0,0,3,6,1619157.73144481,4061988.65389213
27,1,1,0,0,2,990969.266908008,5136557.97106408
34,6,0,0,7,13,2310159.5950912004,4188085.14716103
23,1,1,1,3,6,1873955.91436596,5182210.9232812
32,5,1,2,6,14,3096464.09557512,2824823.11157642
23,4,1,0,6,11,1844044.14265571,4019640.78417456
31,6,3,2,6,17,2703998.81577286,7743769.69004815
35,3,2,1,4,10,2211965.73600352,5666387.86338558
39,2,2,1,0,5,1655510.82056066,3762224.98524776
18,0,0,1,0,1,1653124.29281214,4391832.19568566
20,6,0,2,4,12,2248190.13932032,11240646.129309699
34,4,1,1,0,6,1454421.11985775,5514808.9894363
28,3,0,0,2,5,1117130.18919497,5249969.82645612
31,5,0,2,1,8,2114487.83115276,6284252.08426725
40,5,1,2,2,10,1714713.24236884,5025391.88997836
14,0,1,1,4,6,1825225.01358123,2834583.60374955
21,3,2,1,5,11,2502347.59336704,7440283.41881749
26,5,0,0,3,8,1992134.4837071,4255117.56577525
25,4,0,1,6,11,1396122.5160153,7586644.82101639
32,6,3,2,0,11,2799070.08167519,4793322.33949075
14,0,2,2,4,8,1529514.37230992,4385046.86214733
35,6,2,1,2,11,2429491.02225288,8253238.00406623
28,4,2,1,1,8,2452377.46491517,8865690.73621788
13,0,1,2,0,3,1573318.52076743,2660790.43563628
29,5,0,0,1,6,1558469.36412982,4037989.24472477
29,1,2,2,2,7,2087494.90570049,6210389.7777094
21,0,1,1,1,3,1398315.99924611,3108168.09885491
17,2,3,2,2,9,2394771.38727381,2329418.93328606
40,2,2,1,5,10,2263506.55577656,7444373.55677553
29,4,0,0,7,11,1977928.47916918,7857935.41203295
39,1,2,1,2,6,1334673.71685624,7157251.76211964
14,6,0,0,0,6,1562742.80783306,5818902.75810511
38,0,1,1,4,6,1500861.95018918,5648875.19935882
29,6,0,2,0,8,1936498.49873451,3559275.2081381003
25,2,3,0,0,5,1735231.76946903,7810318.05260339
25,4,3,2,0,9,1962096.08419831,1715895.45855526
14,5,1,2,2,10,2391898.31683651,4541682.55838972
26,0,3,1,4,8,1607481.17542703,6713320.54549305
22,0,0,1,0,1,1584497.88164522,4571103.93350208
10,1,0,2,2,5,1518433.65251707,4036912.45725924
14,6,2,1,4,13,2335209.90681135,6813822.1554001
18,1,1,2,0,4,1459231.95738599,5502922.18192534
40,1,1,1,2,5,1572519.96975092,2246506.87342934
20,3,2,0,7,12,2262356.77677187,5973943.44925502
22,0,3,2,1,6,1382581.97869089,6921228.06930047
34,6,2,2,0,10,1533039.07191789,5208215.06502593
36,5,3,2,0,10,1557839.67765194,5076611.29747098
21,2,2,1,1,6,1503502.76949379,6771954.67292589
32,0,0,0,0,0,665294.551253748,882366.486071983
37,5,2,2,2,11,2191628.83519721,5855103.18935474
10,6,2,0,1,9,2072079.64933833,6591044.91231113
28,3,2,2,1,8,1860798.14868041,5255562.87382996
16,1,3,1,2,7,2040180.18908524,5937837.89450982
33,5,0,2,7,14,2860287.20382555,6311788.6715097
33,6,3,1,0,10,2044385.8023868,9114939.67273679
29,1,0,1,4,6,1372144.92114767,4975130.42214819
30,0,0,2,0,2,1451079.88043514,3202179.50711182
24,0,0,2,0,2,1276561.55882229,4049980.55902289
18,3,0,2,0,5,1461683.0115427,3421682.4633473
18,0,2,0,1,3,1513131.86203752,4849619.46429357
12,3,3,0,4,10,1965524.4801771,2324393.14886644
39,1,3,0,1,5,1271497.46122231,5438383.80811497
40,6,3,0,4,13,2043435.44699576,9088808.86659223
34,2,0,2,5,9,1956579.58137031,4120459.11676353
13,2,1,1,6,10,1688645.29550208,6403120.07696312
27,6,0,0,2,8,1481572.36578185,5405714.23432031
39,1,1,1,4,7,1828082.67484566,3600834.51308053
28,5,2,1,1,9,1345120.84193357,4869215.38560425
37,2,0,1,6,9,2256562.87615765,1220481.0765493999
30,0,3,0,2,5,1775262.99995807,3485069.75815968
26,2,2,0,1,5,1387322.73183534,6287765.67934791
38,6,1,1,1,9,2065601.45845652,4613865.68259601
26,5,2,1,2,10,1841501.3915371003,2388707.28700571
12,4,3,0,2,9,1995281.20061136,5467434.50592958
14,6,2,1,0,9,1781527.6476686,3976559.02792644
19,3,3,0,1,7,1746582.83572913,8180034.41276234
16,2,1,1,4,8,1927694.81782944,2783141.95320218
26,3,0,0,0,3,1073241.68939254,3924150.5607401
39,4,1,1,3,9,1985111.35043911,4646424.80676699
18,1,1,2,7,11,2162809.86522847,7363688.00698467
25,4,2,0,6,12,1942550.23093462,5707362.48548592
29,4,0,0,0,4,1566029.42404894,5758981.25205864
38,6,3,2,7,18,2430878.54316091,9943762.85995915
13,6,0,1,1,8,1713749.80196754,4376313.6540937
26,6,2,2,2,12,1989378.16231781,5339058.20866987
25,3,2,2,7,14,2617700.87622762,7078033.65718857
40,3,0,2,0,5,1350977.58367131,7409881.09107972
40,3,3,1,1,8,1648340.33881405,4726153.43727924
33,3,1,1,5,10,2058223.50519476,7840295.38904452
34,2,1,2,3,8,1781457.83642376,4570715.41865218
30,1,1,0,0,2,1229415.04650895,3624412.8934032004
25,0,3,0,2,5,1195448.70549579,5235582.05207184
25,1,3,2,4,10,2367081.42364481,6420370.90302415
36,5,1,2,6,14,1846440.23018376,6915607.69298927
19,6,1,2,6,15,2463565.22504901,8524990.09404078
20,1,3,1,3,8,1538377.787557,5006459.49745396
37,6,3,1,1,11,2620238.31266777,4184332.22608366
16,5,0,2,3,10,2395397.50352291,4369318.80479556
26,5,3,1,4,13,1714148.27482785,5636741.97344543
39,1,3,2,2,8,2029267.7415238998,9185439.80851919
21,4,1,1,5,11,1815209.29211663,7488431.1965806
13,4,1,2,6,13,2858035.14866198,9599061.12781234
19,5,2,1,5,13,3090664.98875572,10427238.455559
23,5,2,1,4,12,2417692.34059403,5470988.46757414
13,3,1,2,4,10,1679429.00150182,4883481.53355058
20,5,2,2,1,10,1821415.04562555,6315951.84835405
32,5,1,0,3,9,2240350.97394984,8237158.4791827
14,3,0,2,6,11,1879174.07743282,9169036.09738571
29,2,3,1,7,13,1608936.78126154,7414747.10098046
21,0,3,2,1,6,1263164.5109396002,5277510.89364588
21,5,3,0,3,11,2606923.14970579,7499781.68120886
15,3,0,2,7,12,2258364.24894048,6265362.79958038
33,5,0,1,2,8,2079589.03261791,3849933.31446808
31,3,0,2,7,12,2365750.53560381,7370732.14365808
25,0,0,2,5,7,1907592.80847162,7096249.99103201
20,0,1,0,5,6,1762551.91946038,6068353.29150667
16,0,1,1,1,3,1072208.35298562,4496015.88271293
10,2,0,0,0,2,1072986.06104781,3736447.83183948
14,3,3,1,6,13,2356030.4559276,3950382.80026184
11,0,0,0,0,0,1241195.24905283,2929928.04159764
39,2,0,2,0,4,1621421.88828698,6384011.95734079
10,4,0,2,2,8,2064454.60176657,6226970.68395213
28,5,1,2,0,8,2042547.3369994,5353713.69597268
30,6,1,2,5,14,2376441.65712914,6734707.42814065
20,4,0,0,3,7,1978260.06167522,4928090.049034599
32,1,3,0,3,7,2168426.41424832,5340725.85698696
24,0,3,2,0,5,1201143.09229854,5927825.86686007
20,5,3,1,1,10,2123351.42681337,5366763.249967299
16,1,2,0,4,7,1677912.50744824,4767675.36151161
31,0,0,1,2,3,1169165.11936073,3802265.4005638002
32,0,0,2,1,3,1369742.69621759,4632881.71742929
19,3,0,1,2,6,1508891.9749562,2956170.17938241
37,1,0,0,2,3,1246100.66131129,6282056.79735266
17,4,2,2,2,10,1648553.92322518,5540009.18247959
34,2,3,0,3,8,2185497.13819485,5970468.47059783
33,5,1,1,5,12,2326447.30193099,5557998.94518936
31,6,0,2,6,14,2677248.13210346,7623265.62162673
23,0,2,1,0,3,1520621.01638925,6742471.24586321
30,5,2,0,5,12,2267382.10872602,4429506.75398822
29,1,0,2,0,3,1135555.92909482,117810.451239631
34,3,0,2,6,11,2195690.57377187,6560637.19552507
22,0,2,2,6,10,1641555.49910739,8442022.96844634
22,2,0,2,1,5,1768259.91673349,4709010.16993986
10,2,3,2,3,10,2179466.85554742,6813287.92357827
18,2,2,0,7,11,1753867.73646357,3667418.36332502
35,1,1,2,6,10,1856646.12266947,6667616.64074456
35,4,1,2,5,12,1878795.54566512,6736463.16394972
33,3,1,2,1,7,1490589.43549895,6360541.18344806
35,2,0,1,0,3,1679762.37249365,3340787.82269618
20,3,0,1,4,8,1519700.78481402,5054114.20455715
36,5,1,2,2,10,2169695.15446019,8848916.83941806
27,2,3,2,7,14,2707180.12710644,5789176.99394229
32,1,1,2,0,4,1586348.58826983,2799919.98324361
18,1,1,1,1,4,1414863.03338324,4185912.48435606
11,6,2,2,4,14,2290997.07944033,7913276.55861163
26,2,3,0,7,12,1874977.13199793,8263729.88389931
37,5,0,1,5,11,2467855.35701211,6736074.93327391
19,5,1,0,3,9,1715169.57404781,7781712.45540698
37,5,2,1,3,11,1758800.26705159,5926993.39846897
35,6,0,1,5,12,2075447.9020675,6145902.38803723
15,3,2,2,6,13,2574990.79583496,9598168.48088006
20,4,2,1,5,12,1717900.34282389,7723706.60395593
38,3,2,0,7,12,2320972.17281382,8148000.12504693
23,2,3,0,0,5,1733374.82890025,5017597.50923851
26,5,3,2,2,12,2422874.12052767,5382961.32286604
29,6,3,2,7,18,2289299.67068701,8058526.33596687
18,1,3,2,5,11,2509873.4050367,7121474.20998767
34,6,0,2,3,11,2393725.48818944,3649709.6996517996
33,0,3,2,7,12,2560801.22059648,4674297.26277925
16,4,3,1,7,15,2446362.56530489,6598881.47544504
10,2,3,2,2,9,1837271.28311015,3204705.80211852
34,3,3,1,3,10,2147055.3350067004,4522294.35086173
40,6,1,2,4,13,2297838.73167373,3366683.35751987
38,0,2,1,7,10,1870114.97245345,6647883.49292826
25,2,3,1,1,7,1917445.08678813,4881952.06064436
27,6,2,2,6,16,2911298.40366441,9991947.12327468
36,6,3,0,0,9,1706120.18733059,7530880.31072866
11,5,2,0,4,11,1814672.4421080002,3771196.15041272
27,2,2,2,3,9,1968332.7236776,5859592.56689881
33,2,2,2,3,9,2222778.94923827,4788928.65350233
35,3,1,1,5,10,2240938.34948236,4664431.28243972
33,2,1,2,5,10,1918804.36381694,6003984.820601099
39,4,2,2,2,10,2446850.66019058,5623606.81821832
36,2,3,1,2,8,2421050.87082878,3482845.52065277
12,5,3,1,6,15,3172562.71816432,3935279.71401787
18,1,0,2,0,3,1173594.70240066,5122073.78341484
26,2,1,1,7,11,2155274.53499011,5734963.64353338
15,1,2,0,3,6,1467580.42815779,4199710.78223027
38,1,1,1,2,5,1996913.92201358,3792820.15784078
10,3,0,0,7,10,1677904.64540575,7908344.84172742
27,4,0,0,3,7,1628499.50069996,3713247.19765668
24,6,2,0,0,8,1599064.87971139,7421507.86500733
14,1,0,1,5,7,1718938.20618916,6270119.92025873
14,5,2,2,2,11,1773824.3337538003,8044362.11817549
12,0,3,0,5,8,1662859.41157972,7630632.000678999
15,6,2,0,5,13,2559029.80855529,9842618.10201836
14,5,3,1,0,9,1699301.27568651,5903992.672744201
19,1,3,0,1,5,1581460.92352208,5023383.72437868
17,1,1,0,7,9,2080439.41553098,5537671.58144603
13,5,0,2,6,13,2675474.75864405,7581184.61394487
37,2,1,0,0,3,1352608.56615683,2532632.29091263
10,5,2,1,6,14,2448242.42446461,4186368.06644336
38,5,3,0,0,8,1444827.2324030001,6565142.65551585
37,5,3,2,0,10,2317279.06168546,6281508.46940917
27,0,1,2,1,4,1754595.34832705,5593345.02632728
32,4,0,1,1,6,1500383.57545725,3945363.97819811
36,0,0,2,3,5,1757069.36812808,6396039.4097245
35,0,2,2,7,11,1947054.3180136,5552584.3043742
33,0,2,1,6,9,1542603.67068835,5641071.65705675
16,1,2,2,0,5,1285069.65954232,3609515.74794728
25,6,1,0,3,10,2267638.3875952004,7044986.40400996
15,1,1,1,5,8,2017689.52533521,5116678.54515062
20,0,3,0,0,3,1197975.61409299,1149811.6350331998
13,1,3,0,5,9,2219905.49283088,3378312.37989674
12,0,1,2,4,7,1365463.64599336,5780900.28242015
32,1,1,2,1,5,1616534.21929721,5008834.88902601
12,5,3,1,3,12,2194332.87287805,8958183.48618003
36,4,2,0,5,11,2087300.04939469,5745567.97583461
38,6,2,0,7,15,2608406.0575153,7811051.35577151
17,1,1,1,6,9,2035621.8633383,8745402.41708987
40,4,3,1,6,14,1942431.37710276,5005447.20002484
20,6,2,1,3,12,1546211.99553915,5210602.21175872
39,5,2,2,2,11,2447397.98124704,7315304.6509217
24,6,2,0,7,15,2531668.3226985,6386179.80264731
11,2,3,2,6,13,2173093.00742609,11418976.676669901
21,5,0,1,7,13,2966977.43979262,9644243.48827909
18,2,2,0,4,8,1393137.84260487,6986332.2305285
14,0,1,0,2,3,1305427.36115316,3838751.24724269
29,2,1,0,5,8,1938777.57971878,5872567.90014618
13,6,0,0,2,8,1859641.91992275,6124855.83233274
39,1,3,0,3,7,1859118.69503418,7175767.38526122
27,6,0,0,4,10,2127770.01645547,7960077.04642019
16,2,0,1,6,9,1531367.85651949,3734685.25318121
35,0,2,1,0,3,1367610.47985676,4908261.750458401
16,0,1,0,3,4,1800137.40210361,3781597.52124375
16,4,2,1,7,14,2436651.27808055,8402261.95776528
29,6,1,1,5,13,1611247.87042512,3744711.79256281
36,4,3,0,2,9,1977617.49484802,2574369.51423219
37,2,1,0,3,6,1100511.18661825,6533554.43464038
10,4,0,2,5,11,1803996.07379607,8221574.86790093
31,0,0,2,7,9,2123721.86998088,5068471.10357234
15,2,1,2,6,11,2194137.85377997,5906176.32780701
30,4,0,1,5,10,1853539.43252567,7483281.28022802
10,0,0,2,6,8,1350320.74444184,6585046.72590887
18,1,2,0,4,7,2071733.1449323997,3387719.15777399
24,0,1,2,4,7,1821361.17599632,3937614.9388642996
25,4,2,2,7,15,3462023.1664358,8535109.3543909
14,3,0,0,2,5,1551519.467892,3506505.62934463
11,5,1,1,2,9,1848179.04818271,5031146.6883832
38,4,1,1,1,7,1880926.9642547,3505541.33676037
32,5,0,2,7,14,2697046.6090797996,6304277.01829359
35,2,2,0,1,5,1612724.0852415,6132688.01397405
24,3,3,1,6,13,2143712.76424627,5571355.267136099
19,2,0,1,2,5,1504689.24643372,4897218.04816458
29,2,0,2,7,11,2548942.33039299,9401936.56572437
30,4,3,2,7,16,2043056.88953258,7761348.99872603
39,6,3,1,4,14,2138255.75558987,6527863.57312609
33,6,3,0,2,11,2036515.92346714,7183200.04344391
10,2,0,2,2,6,852703.747651533,5352518.62877604
13,5,0,0,0,5,1818706.73725981,5426114.367111
16,0,1,2,3,6,2045254.76200311,4146024.9158795998
39,4,0,2,0,6,1558017.35121155,1041651.20936917
14,5,1,0,6,12,1797427.16218958,6922764.54049452
18,6,1,2,2,11,2253955.68685603,9048467.61696621
12,3,0,0,7,10,2002963.50600437,7133638.09775879
13,4,1,0,4,9,1862963.43232866,3572270.62871228
13,1,1,1,1,4,1250450.85919658,4319847.55046924
12,5,0,2,4,11,1435376.59689413,7672480.11879111
33,1,1,2,4,8,1364250.26286831,6202472.58719277
37,6,0,0,3,9,2204505.26789611,6108998.73173149
22,3,2,1,5,11,2242523.98752714,5808286.36368691
30,1,0,1,6,8,1997134.12582922,8084417.07310771
34,5,3,1,0,9,2135784.50913706,4982562.33346676
29,4,1,1,0,6,2088249.39904537,5164662.77768534
40,5,1,1,0,7,1393387.02834164,5504221.81122025
24,6,1,1,2,10,2064057.79782377,6676819.88637224
31,3,0,1,2,6,1782457.35701021,3379940.95425884
20,2,2,1,5,10,1941910.72689625,5515283.974616299
14,0,2,0,2,4,1163799.02166866,3755993.43181275
27,4,0,2,2,8,1954512.56503804,2562783.55815076
11,3,1,2,1,7,1913217.97467728,5206949.59773132
31,4,2,1,0,7,1645341.31652654,6545804.5402474
20,2,0,0,6,8,1831359.6917759997,3581096.78090951
23,1,0,1,7,9,1881666.16519734,2073854.38518666
24,5,2,1,3,11,1656632.37478146,8384244.3881537
20,5,0,1,3,9,1386502.27073105,6734898.15875665
32,1,3,1,2,7,1783546.21550139,3744192.18116697
29,2,2,2,3,9,1793358.18210542,4850262.47763672
36,3,1,0,7,11,2184321.20098048,4903042.88316657
10,0,1,0,5,6,1217392.70579122,5422988.77104813
20,5,0,1,2,8,1570195.60474032,3772139.90713661
26,6,3,2,0,11,2416841.44181621,9537537.42497001
17,1,1,2,6,10,2097744.19949908,4986322.70184898
20,2,2,0,4,8,1687924.71313874,4247929.1830235
13,4,2,0,0,6,1638948.29945626,3037458.24245035
29,3,0,0,4,7,1848789.06887064,4717325.10750687
17,2,3,2,5,12,2113640.10852548,5857721.89422828
26,1,0,1,4,6,1310397.44521275,3182840.36516982
21,0,3,0,4,7,1946419.24909415,4814203.68829522
16,5,1,0,6,12,1900740.95172821,6050109.61052945
17,4,1,2,2,9,1993344.03053462,5629538.49046014
27,1,3,1,0,5,1197144.87469945,4116621.420931
20,6,2,0,4,12,1325123.38762818,6295081.71899487
20,2,1,0,2,5,1767902.94219459,5437180.72787104
13,2,2,1,5,10,1498387.93236451,6780562.85089486
22,4,2,2,5,13,2921670.70378777,6793393.32325966
22,1,0,2,3,6,1586283.43410021,4125732.26650863
21,5,2,2,1,10,1982954.84649705,4509233.38682527
16,3,2,2,6,13,1909606.10252005,6046119.509286099
33,6,1,2,6,15,3498966.01659722,7912148.07011804
15,5,0,2,0,7,1510475.67191988,6359363.01654694
12,4,3,2,5,14,2612313.92964567,9892667.13754411
11,5,3,2,4,14,1596457.30978548,5340634.84695441
21,5,0,2,7,14,1679665.90124029,5079623.75054398
24,0,0,1,4,5,1254707.01558494,4490158.50215505
37,1,1,0,7,9,2034031.81180595,4377277.06281254
36,1,1,2,2,6,1829003.03330736,4721450.06372922
11,6,2,1,0,9,2400374.61855299,8074874.61169702
34,0,3,1,5,9,2026375.49808532,6092879.44541684
37,0,2,1,0,3,1050648.08629786,5877796.59913768
40,4,0,0,7,11,1822869.14631924,6589619.45157527
38,4,0,1,7,12,1520033.57248072,4300839.55970501
27,6,1,2,4,13,1777363.31028937,5069756.6158766
38,5,1,1,0,7,2059423.21857218,4134384.79519244
11,1,3,1,0,5,1687126.17637425,3807922.37015357
35,2,2,2,7,13,2354716.28572954,6817879.63958683
34,4,2,1,3,10,1689663.3531409,4294223.89868554
15,1,1,1,4,7,2138937.38142786,5574362.4314351
35,4,1,1,3,9,2072966.22560013,5793576.45101073
37,2,2,0,0,4,1424680.83847443,3895029.21394362
27,0,3,1,0,4,1521875.18346888,3982854.55484418
31,0,1,1,3,5,1611471.51558906,4783064.7397503
13,3,3,2,3,11,2517915.44564677,5833057.7157196
37,2,0,0,0,2,1358382.70080951,4401943.43882044
16,1,1,1,4,7,2081230.72656814,6918724.35287096
32,2,1,2,1,6,1484532.09638593,5027411.3024318
14,2,2,2,2,8,1625141.12131703,7401519.40199327
36,2,1,1,0,4,1172542.9888654,6442045.60250598
31,6,2,0,2,10,2312531.5591586004,9280675.80810433
32,4,0,2,7,13,2759042.62889193,6910047.8703645
12,1,3,2,3,9,2288497.27458685,5480195.42544116
27,6,0,2,3,11,1954496.30197981,3812769.5324836
21,4,3,2,4,13,2241447.84239125,7004927.77717115
37,6,0,0,6,12,1797464.20856218,10866166.1721495
26,2,2,0,2,6,1491588.68314771,6464300.15781142
17,4,3,2,3,12,2294565.78415637,7848970.83556371
24,2,3,0,2,7,1780250.8410228,5375085.33391875
10,5,0,1,3,9,1955763.18601916,3641964.54417401
27,5,1,2,2,10,1946437.99595574,6933222.94583789
40,0,2,0,1,3,1287645.61174082,3998523.28455355
35,1,0,0,4,5,1483626.44870285,2486323.43653578
18,4,2,1,0,7,1676844.61467123,4271877.96863251
20,6,0,1,1,8,2045627.25392553,3191240.40108981
21,6,0,0,1,7,1481948.88636289,4365664.97019312
28,3,2,0,6,11,2084050.22470619,9484503.40935808
31,0,1,1,1,3,1224851.47863985,3599040.87199916
24,6,1,1,0,8,1628044.15768389,4320436.30229214
11,4,2,1,4,11,2420836.190338,8478473.27013227
15,5,3,2,7,17,2267825.18583772,8597140.35698288
11,0,1,1,6,8,1920015.35183242,4539505.89316701
22,2,3,0,5,10,1390063.55407471,3377963.52522228
30,6,2,2,6,16,2616875.96734618,8008491.48040026
28,4,0,0,0,4,1225364.17057721,2653803.48648445
10,5,1,2,1,9,1704644.77282628,7406972.16663846
13,2,3,0,1,6,1907431.76248367,6069917.96791606
14,0,1,1,0,2,1168706.42358712,2225802.8653702005
36,5,1,1,7,14,2664566.43641331,8658416.72972247
34,1,0,1,7,9,2151623.23508893,4219308.28699953
10,0,0,2,6,8,2048843.53236677,5100727.69478461
32,6,0,1,0,7,1275330.89442242,4436103.67077218
24,0,1,0,2,3,1127137.10475391,2330308.94821674
34,2,3,1,2,8,1705548.68753002,5230443.07017838
21,6,2,0,7,15,2478829.70763355,5469566.73340784
27,3,1,0,0,4,1606461.56992662,3894408.29997208
10,6,2,2,6,16,2371969.18834565,7062574.54579527
32,4,2,0,1,7,1866438.44099003,7851757.38104685
18,5,2,1,5,13,2432188.91082107,7041458.34832748
26,0,3,2,3,8,1603935.508257,3623840.45495479
28,4,2,2,1,9,1950585.13409168,5509039.28127558
27,0,2,0,4,6,1415510.75366793,7490659.17460221
22,1,0,2,6,9,2215373.70280657,4080430.58738424
15,2,1,2,3,8,1908621.78196771,7871774.96845963
40,5,1,2,5,13,2122907.88695111,7595132.73395597
21,5,0,0,6,11,2227268.31828309,5538301.52901224
33,2,0,2,2,6,1415317.56501607,3219254.34692247
19,1,1,1,1,4,1638358.08315532,4708733.1207945
16,3,2,2,6,13,2382849.63020529,6411713.42886906
18,2,1,0,7,10,1670426.66755729,5162321.23912901
12,2,2,1,6,11,2299683.286878,6935781.20763557
12,5,2,1,1,9,1603322.66821248,6767376.773976999
27,2,2,2,6,12,2010528.2034173,7654492.8809524
23,6,2,2,1,11,2286067.43533185,10094055.3948455
17,0,0,2,3,5,1323556.49041313,4100487.2305862
18,2,2,2,0,6,1920290.69109708,5934127.39210392
36,4,3,1,4,12,2366149.8875337997,8322573.22034912
36,2,1,2,2,7,1920139.67003505,4865849.88719806
28,5,3,0,2,10,2022255.74451839,7512931.070979901
28,4,2,1,4,11,2236993.35743559,4581770.33237732
34,5,0,0,3,8,1867227.18228664,4129864.3041791
17,0,0,0,3,3,1358906.68005489,1397012.91592273
13,2,3,2,1,8,1757699.63285024,6839117.19928006
32,3,0,2,3,8,2433722.0713232,4429795.357322
20,1,1,0,7,9,2297537.04710329,7464200.34343228
28,0,1,0,4,5,1614242.37705905,4998392.03612414
16,2,1,2,1,6,1660010.29666686,1590724.5794567
38,3,3,0,0,6,1700316.73571454,6577972.45351463
30,1,0,1,7,9,1861776.73273257,5150005.01591546
40,5,1,1,6,13,2259078.60671604,10027174.427337
10,0,0,1,5,6,2037936.1828913002,4702395.1011802
28,0,0,2,3,5,1470031.32834776,1318577.08517603
27,5,2,2,3,12,2680047.88526612,5516501.60054045
35,0,1,1,3,5,1645062.05620404,3900486.78298472
18,0,3,1,3,7,1829321.70441651,2394538.94391175
15,2,0,0,0,2,954659.683268207,5473281.42336687
40,5,2,1,1,9,1725838.29969492,3255239.25040956
26,1,2,2,7,12,1893272.5451665001,8302114.0057725
37,3,2,1,5,11,2367489.73211588,4252579.88027385
35,0,2,2,4,8,2161429.79036465,3218257.84005254
39,1,3,2,6,12,2481382.23685309,7316692.27829271
35,0,3,2,1,6,1574376.75262538,5404749.19576506
34,5,3,0,3,11,2187537.8266698,5479958.98188012
25,0,0,0,6,6,1806358.87623647,4436828.93345801
31,5,0,0,4,9,1552385.94466549,8692427.96564307
29,3,1,2,3,9,1960612.71649361,7767615.00721853
12,6,1,2,1,10,2195646.76660554,3548730.70401604
39,5,3,2,7,17,3726694.93644643,6715696.04331205
34,6,2,0,2,10,2363170.92683102,6867801.23903779
39,6,1,0,5,12,2047249.52017594,7792612.92045724
10,2,3,1,2,8,2354829.04051506,2489356.93744245
24,4,0,1,4,9,2269730.4700613,6453561.64816939
24,6,1,1,3,11,1644074.73344294,8752168.055016
36,4,2,2,3,11,2245662.52871018,7926490.5529027
12,1,1,1,0,3,1237741.81126155,3380888.75458755
10,6,3,2,5,16,2434925.37531542,10388151.2659771
31,6,1,1,5,13,2473827.92047548,7628506.85950009
18,5,3,0,4,12,2063047.98577832,4420796.80836072
33,0,0,2,3,5,1314334.58118599,5220935.13070072
14,4,2,0,4,10,2234841.9629662004,7512757.05381921
37,3,3,1,5,12,2144072.684677,4142205.6719580004
13,6,3,0,6,15,3045444.11024737,5114492.90122485
24,2,0,0,7,9,1459992.36463803,7985639.81900954
22,1,1,0,2,4,1209122.63432155,5179393.65709249
12,5,2,1,1,9,2146481.67558875,5474076.48088655
23,5,1,1,2,9,2289703.17459384,6804728.59831391
28,6,1,2,1,10,2481021.68868998,7883903.34021298
37,4,1,0,7,12,1539305.20343753,8047660.67109661
33,1,1,0,6,8,1824276.89015271,7104044.78888813
35,3,3,1,0,7,1911275.47232279,6199116.38764834
39,0,1,1,7,9,2147479.67387856,4414862.87476532
32,2,2,0,5,9,1526965.48650024,4445033.27840906
10,4,2,2,7,15,3159141.44908179,8920449.0040714
38,0,1,2,4,7,1913551.12135329,3468428.8714333
20,6,0,0,3,9,2031651.86678228,7359779.73738099
26,0,2,1,7,10,2215223.78770347,4135218.57949241
32,6,2,2,4,14,2808362.49848155,8193096.21363082
23,6,3,0,6,15,2869321.55863978,6414531.94439416
37,3,1,1,5,10,1895797.65520688,6727121.52793999
10,4,3,0,7,14,2712094.39231358,7825540.61514104
39,0,1,0,5,6,1399761.9478613997,4609183.66676876
36,2,3,1,6,12,1882232.37290476,5128374.84117342
35,2,0,2,2,6,1599467.39964072,4538491.97004903
25,2,3,0,1,6,1649192.9744874,4399536.67080174
29,0,0,1,6,7,2060199.55509799,4190458.08752896
27,3,1,1,2,7,1413935.58557518,5202843.19631638
33,5,2,1,7,15,2628315.29328599,8333887.26383365
20,3,0,1,7,11,2055077.88483579,6064614.45877697
12,4,0,2,3,9,1686468.87034615,5197001.77461073
29,3,2,2,1,8,1771057.46097863,7061436.78282072
38,0,2,2,1,5,1670150.38026411,5504342.39782851
29,6,3,2,0,11,1660308.90576016,7009251.70623475
23,2,2,2,0,6,1744005.92499835,6822816.760623099
30,2,0,0,6,8,1678067.28027564,3984082.91485001
24,1,3,1,2,7,1585259.76048073,4207050.77108225
24,1,2,1,6,10,2293198.99273119,6739644.90449721
10,0,2,1,2,5,1437538.04920041,2214899.85042031
31,1,2,2,2,7,1918277.32971648,6128835.90128027
34,6,2,2,7,17,2434136.43048726,6770913.40172652
12,1,3,1,4,9,1320001.64517608,6792443.86107642
15,3,0,2,7,12,2223196.60043704,6006175.91003267
33,4,2,2,5,13,1710272.75080251,5440756.2961465
33,5,3,0,4,12,2204709.92868633,10293921.9906306
40,1,2,0,3,6,1425185.11954365,5137311.18990242
19,5,1,0,2,8,1638722.72373317,6018600.73927477
34,3,2,0,2,7,1711139.10198342,5285720.99709506
25,4,3,1,6,14,2072114.73392594,8240102.64430877
38,6,1,2,6,15,2114071.35181852,7936644.94637962
11,1,0,2,7,10,2084020.79301493,7928516.18170534
29,4,3,0,1,8,1281468.14620539,6010579.79168584
17,2,2,1,0,5,1558732.95431523,4093357.76091794
34,1,0,1,1,3,1283427.06034188,7077541.83966134
22,0,1,1,0,2,875722.938734651,799172.029721135
18,2,0,2,0,4,1261696.9006196002,4995407.06173885
17,5,1,2,5,13,2746208.30884021,6532789.29157515
34,1,3,1,2,7,1417106.19629177,3671544.25417718
17,2,0,1,6,9,2140567.45279278,6504294.96799535
11,0,2,0,2,4,1254065.00836393,4482213.18520104
16,6,3,0,3,12,2405932.53427066,4922005.21665765
15,6,2,0,7,15,2242894.67786394,7259223.71234231
37,6,0,0,5,11,1840040.62602724,1722780.62375233
10,6,1,0,3,10,1635588.96330993,5397984.29826348
15,3,0,1,5,9,1637983.08271206,6490752.63381755
37,1,2,1,0,4,1596710.78443086,1921213.81395212
22,6,3,0,6,15,3016914.30653529,8203260.77652253
14,5,1,1,4,11,1431214.99150619,9068757.7454931
30,3,3,1,1,8,1792820.9637405,6194472.36623087
17,5,2,1,5,13,3012571.84130472,6093007.57935265
35,0,0,0,0,0,1134951.78265891,3934277.16352664
15,5,0,0,4,9,1350000.16654717,5054011.18478656
14,3,3,1,7,14,3284436.54481729,7814834.97349704
39,3,0,0,1,4,1290209.58550041,3535909.31546316
26,4,3,1,3,11,1676502.64148494,6886684.7767623
22,2,0,2,3,7,1865945.45530713,4087944.09876004
22,2,0,1,1,4,1519856.71205734,5652101.810202099
16,1,1,1,4,7,2092279.09194243,4754354.22907133
13,2,0,1,7,10,1940796.05463422,8152189.37515923
20,0,3,1,4,8,1968196.48689583,4527463.93950148
18,1,0,2,0,3,1236598.08102991,4407128.40586383
29,2,2,0,5,9,1603520.57135932,7615479.430068499
36,2,1,1,0,4,1525179.33598061,2232549.28882548
26,6,1,2,5,14,2059903.81554332,6962345.30869223
18,4,0,1,0,5,1701873.48436917,3847850.93694599
13,3,1,0,7,11,2258891.86258208,5660497.3567063
34,4,3,1,6,14,1830566.29914296,5264614.49083141
33,5,0,2,0,7,1927843.70512574,3589043.69237097
26,0,0,1,3,4,1488502.22417368,2397386.88940517
30,0,2,0,6,8,1684532.66935343,4714138.42317451
22,6,3,2,2,13,1776598.52050005,8446587.47410794
34,4,3,2,4,13,1662941.32467554,7621479.31881343
35,5,2,1,0,8,1666902.86454954,4452600.90987735
19,4,0,2,3,9,1810053.23890133,8298614.26665829
22,1,1,0,6,8,2165851.46667188,5581344.76727482
24,0,2,2,4,8,1435380.90556276,5980294.8354963
12,4,1,0,2,7,1437038.48611059,5683492.09839788
10,5,3,2,3,13,2785294.14454638,7130960.74068655
27,3,2,0,1,6,1616843.65429719,6154080.26206548
19,0,1,0,2,3,874960.8880765729,4506210.26154844
20,2,3,0,5,10,1656749.6706674,6295537.87356995
30,6,0,2,5,13,2583323.13142279,8849644.45526037
12,4,3,0,2,9,2059003.78984487,4140821.57418265
25,2,0,1,0,3,1231407.0558886002,5049968.9485272
26,2,2,0,7,11,2170757.95484702,7237539.104726801
12,1,0,0,2,3,1459405.13753244,3781305.74478301
15,0,1,1,1,3,1434511.85035713,5335903.73330027
29,6,2,0,5,13,2042768.34764096,11626535.333610902
14,2,0,1,4,7,1701330.00341978,5583531.91454816
21,3,2,0,2,7,1773500.45112331,6423466.78366264
23,5,0,2,4,11,2265844.62228267,4880974.7566378
32,2,1,1,4,8,2195375.97059902,5810807.6083227005
24,4,0,2,3,9,2068204.21400725,5653303.56520359
37,2,2,0,7,11,1937516.47553182,6543808.97999107
11,5,3,2,1,11,2355120.25952493,6273987.97554412
35,5,0,0,5,10,2108775.5922745,5993550.97607123
26,0,2,0,3,5,1527105.53588856,2730704.96003573
32,0,0,1,5,6,1660910.25196164,7885446.65612961
26,5,0,1,0,6,2048826.70993345,4243649.12730512
39,2,1,1,5,9,1998997.10724145,3898106.74204909
24,3,2,1,4,10,1958204.65205686,4731549.57979042
21,0,2,2,2,6,1441819.03676738,5281814.91747675
20,1,1,1,4,7,1563766.33487085,5539796.81578951
36,1,3,1,3,8,1482961.62506082,2533175.3221102995
15,1,1,0,2,4,598972.795524701,3153573.24617056
39,4,1,1,1,7,1358904.25560189,4904604.74945781
39,5,2,0,7,14,2182661.61565811,9933563.177695598
13,3,0,1,0,4,1614262.87778006,5393398.87331619
28,3,2,2,3,10,1816173.27405464,11245405.981425
28,1,0,1,4,6,1493875.01339743,5850298.56862177
12,6,2,0,4,12,2110000.5468225,2762800.18660536
20,5,1,2,2,10,2090401.00744677,5084308.45691394
26,3,0,0,0,3,1188770.65968515,5429107.43505898
36,6,3,0,4,13,2169964.16217333,7594222.71800937
36,3,2,0,2,7,1406904.62357911,5366621.16472063
36,4,2,1,5,12,2088907.8919336998,4632300.19537172
13,6,3,0,4,13,2991683.37253176,9311060.62078815
13,6,0,1,7,14,2830767.94560908,3843562.75628508
36,5,0,2,4,11,1750643.53726589,5702613.59840653
13,1,2,2,7,12,2238272.08301319,7445741.49522394
16,0,3,1,7,11,2593951.27477654,7336084.93009383
26,2,0,2,6,10,1969626.1617573001,9561929.71270266
16,5,0,0,7,12,2261662.39425399,4464371.31238847
39,4,0,2,3,9,2050576.5525171002,5382244.6993963
17,4,3,1,1,9,1822409.6578924,6050984.35721161
33,0,3,2,2,7,2144205.1945308996,3871637.1398632005
11,1,3,0,6,10,1869624.63057877,5862116.30676389
15,0,1,2,6,9,1724709.6514182,5135179.12477121
40,0,0,2,6,8,1926508.71106105,6075511.2412223
36,4,2,0,5,11,2026420.9201063,5267830.31909413
36,6,2,2,7,17,2492906.98178903,10619147.618108
30,1,2,1,6,10,1611222.78824072,6412834.51691067
32,3,1,0,0,4,844658.436749479,3764484.29266437
10,2,1,1,4,8,1781688.5483696999,6348635.3623419
21,2,3,1,0,6,1898310.11648495,5044014.4369419
13,5,0,0,6,11,1931841.8664968002,6120619.59790962
32,1,2,0,5,8,2077791.87693215,6612213.37283791
11,2,1,1,6,10,1938501.19785064,6059643.65324973
30,3,1,2,7,13,2252091.44178097,6104956.76261071
19,0,1,1,1,3,1089063.60386698,3139916.69758794
37,2,2,1,4,9,1597423.58385255,4608533.93926739
18,5,3,2,4,14,2362879.48174468,6980039.33664537
29,1,2,1,6,10,2415989.0329724,8724951.20610879
27,6,1,1,7,15,2504177.03750755,7440480.62622779
34,6,3,0,0,9,1645182.07979718,5086901.89379526
35,5,0,0,1,6,1398779.1316085,6149706.139685
26,2,2,0,3,7,1485424.36388907,2256897.56197588
12,4,2,1,4,11,1803105.37211402,6147087.76004611
37,4,1,1,5,11,2429364.49482321,7384657.37305014
18,4,3,2,7,16,2486900.81341376,6306337.56847131
13,0,0,0,6,6,1405448.04772457,2810509.32725696
22,6,1,2,0,9,1880535.48978479,5398622.41443689
22,3,1,1,4,9,1564682.72924897,7850560.84902398
21,4,3,2,0,9,1974879.90753522,6757786.59848714
17,3,1,2,0,6,1404501.45147286,5902801.64251443
32,2,3,2,7,14,2447910.27974071,6950316.64926784
31,0,1,1,1,3,1362085.05295391,5919274.3614467
13,3,0,0,3,6,1731642.32986524,3534116.07945187
15,4,3,2,1,10,1548036.99231192,6574130.74785404
28,1,1,0,3,5,1055692.85876182,7263008.35848585
25,5,1,1,2,9,1558741.58011894,6927496.11707927
33,3,0,0,2,5,1505796.30320836,3449386.22548891
37,0,1,2,5,8,2049950.0751036,6323179.59240668
18,4,1,0,2,7,1954235.43620856,5406442.59752316
11,6,0,1,6,13,2323945.49770912,5982187.25953391
33,6,3,0,4,13,2336899.64700847,5473555.74963199
22,0,2,1,2,5,1547944.47928891,2886924.23645798
27,5,2,1,5,13,1786793.06098048,4214138.1822123
38,4,0,1,5,10,1668377.41354607,3372472.74569778
39,2,0,0,5,7,2055336.39705028,6278626.57539804
32,4,1,2,6,13,2779333.46667905,5490272.63173459
21,4,2,1,3,10,2430610.32278874,7541136.79771512
13,6,3,1,6,16,2704339.65270795,5332623.17973665
22,6,2,1,4,13,2526096.64008463,5332662.11977867
21,1,2,0,5,8,2337395.16828634,5658529.97775483
23,2,1,1,6,10,2032048.80916522,5700824.63970825
32,3,0,0,2,5,1596121.13045289,7984890.62793919
30,2,2,1,4,9,2000492.93899817,4700223.15442513
11,0,2,0,3,5,1524048.82006742,4003073.70620135
40,0,0,0,5,5,1720642.90203881,6054580.91930298
18,0,1,1,5,7,1626316.86616928,1970919.45013851
17,6,0,0,5,11,2144099.96041404,6320360.28760577
10,6,0,1,1,8,1746918.77247824,4866685.87545857
19,2,0,1,5,8,1810677.41738778,5629419.30007042
22,5,3,1,6,15,2483410.07447151,7792880.81856712
17,2,2,2,3,9,2154346.16234794,5901668.73675157
34,2,2,2,5,11,2011576.62391478,3168747.07153045
19,4,2,0,4,10,2267615.51657547,3315217.44261047
30,3,2,0,5,10,2485822.68344554,5052753.01926136
36,5,2,1,4,12,2507846.45463027,8048252.0568004
22,3,3,2,0,8,1338041.41106858,5403297.66651268
15,6,1,2,2,11,2272815.92008926,3068509.63649159
18,6,0,2,7,15,3106783.34349349,5686771.39259747
32,5,3,1,2,11,1823671.57263283,4490566.26741379
21,0,3,2,5,10,2575435.40558467,6703217.75897226
38,6,0,2,6,14,3081203.63536952,6049011.47559765
13,4,1,1,1,7,1730309.90266047,2572391.87389016
15,6,2,0,3,11,2447083.13907277,3673954.77130075
21,3,1,2,4,10,1778780.2932551003,6778651.90974842
21,4,1,0,5,10,2998690.77341285,7173561.46166862
38,0,2,0,0,2,985412.473679393,4852183.45499525
19,5,3,2,5,15,2700748.05213721,7476596.600544901
36,6,3,0,4,13,2425912.65189516,6007805.16833372
35,3,0,1,4,8,1999661.30781996,4618959.25936209
17,5,0,1,6,12,2387447.51154897,3923898.8998277998
24,4,2,1,0,7,1605637.92007841,1913895.18599089
24,2,1,2,3,8,2339424.99784006,3505144.40246462
28,2,1,2,7,12,2428269.56781711,4807392.9484728
23,2,1,0,4,7,1496885.77726928,6327148.62993163
35,4,2,0,0,6,1696916.87929961,4023097.56191936
24,4,2,0,0,6,1622562.08775748,7251866.60161025
15,1,3,1,2,7,1420001.30521257,5783781.15327409
24,5,3,1,5,14,2942049.38852263,5350672.01083661
33,4,0,1,4,9,2244522.71589379,4660619.15439947
38,5,2,1,7,15,2535951.67474744,9605300.38871555
37,1,0,0,4,5,1353165.22433767,4007064.22871633
33,3,2,1,3,9,1765549.42504322,5002720.67002866
40,2,0,2,2,6,1391677.00474718,3778828.56759707
26,6,2,0,0,8,1916633.02319399,9453186.87885546
29,2,2,2,5,11,2407989.08880763,5063417.91981448
19,4,2,1,7,14,2238906.88031065,10164012.6553836
30,4,1,2,4,11,2314401.95141183,5933902.06899769
26,0,3,0,4,7,1687323.15217978,5832011.87565389
33,3,2,0,1,6,2071200.58801579,5749193.95796632
40,4,0,2,6,12,2562049.58291929,8129997.84425
29,4,3,1,5,13,1812177.62781985,8305897.35536757
30,2,3,2,3,10,2414173.75342982,3447543.41136941
26,4,3,1,5,13,2232170.73636148,9705459.03717415
31,6,1,0,6,13,3020561.44622326,7688880.3570759
32,5,3,2,2,12,2207986.43706722,5075724.70531847
32,5,1,0,7,13,2259559.59456382,6550434.43782029
40,6,3,2,7,18,2427074.39968113,6330860.05363313
15,3,0,1,6,10,2301685.34209967,8967421.64160201
26,4,0,1,4,9,2068216.81113551,7004228.83200093
32,2,0,1,7,10,2282386.25694291,3695379.30659143
17,2,3,1,1,7,881254.647070097,5416426.65936195
38,5,3,1,7,16,2298195.65338564,7502999.36016044
10,0,0,1,2,3,1395830.80571472,6677195.66087527
23,2,2,1,4,9,1762936.61719232,4993306.72072018
17,3,3,1,7,14,2705501.70113884,11313789.308024
18,3,1,2,1,7,1345712.639699,6878338.392845199
34,1,1,2,0,4,1281440.69195768,2813741.39585831
10,0,0,0,3,3,1284708.12424026,1468331.02743813
33,1,3,1,6,11,2383699.13954786,5538846.33958036
26,6,0,1,3,10,2149952.18134857,6997555.2023752
22,5,2,0,4,11,2708113.41877335,8850730.38072331
34,3,0,2,5,10,2044300.72996864,9878102.66037108
36,1,1,0,2,4,1454911.46349079,1871627.42721551
32,4,1,0,5,10,1867967.04610109,5667289.59352984
15,0,0,1,2,3,1528945.1736817,2801194.44400968
25,4,2,1,5,12,2513798.17499666,5338797.06169683
14,4,3,2,0,9,1756456.52214363,7419777.01546755
14,2,2,1,3,8,2029099.06936288,2470855.76321803
24,0,0,2,1,3,1532642.82954447,4773566.16639804
32,1,3,1,6,11,2489153.77813003,2967580.23629467
33,2,1,2,5,10,1424242.50581476,7553081.70127054
27,4,2,1,1,8,2150494.44221033,5709734.40602907
24,5,3,2,2,12,2612788.55376543,5688549.87641785
26,0,0,0,6,6,1648717.9524474,5584346.14804797
16,4,1,0,0,5,1482349.12670083,5340697.32640873
22,0,2,0,2,4,1194968.75727592,3173878.02926869
23,3,1,2,3,9,1985455.89012102,7585888.34118519
19,2,3,0,4,9,2624963.9875024,6128099.74154133
19,4,0,2,1,7,1529766.40032247,6476908.95744949
25,1,1,0,7,9,1580966.20182005,9348851.30582562
40,6,3,2,7,18,2749584.49995257,13600018.688914599
22,2,1,1,5,9,1659012.65945763,6097013.75972279
10,4,0,2,4,10,1827967.91537793,6073118.38256776
15,0,2,0,6,8,1606415.11586486,8304270.32030947
39,4,3,1,2,10,2189758.57775191,5216713.75663915
11,6,0,2,4,12,2588463.88798281,9536063.61825488
26,3,1,2,6,12,2436915.73682967,6402167.93817329
13,0,1,1,7,9,2208768.04708188,5677132.89569614
36,4,0,1,4,9,1793027.64000605,6965588.50823389
17,3,3,0,6,12,1553878.8155152001,6411187.71333563
28,0,0,2,1,3,1227289.23741829,2571235.75290359
20,0,3,0,0,3,1157463.08415643,1006946.82025031
25,3,1,1,5,10,1809934.77687721,7250796.19303841
15,5,0,0,3,8,1653550.03985607,6967429.69217405
29,3,3,2,0,8,1749381.72800311,7450956.46737668
36,4,1,2,0,7,1398695.64552169,5296078.99480803
36,4,3,1,6,14,2391370.57657404,7447656.89174103
34,3,1,2,3,9,1854195.44459549,4560821.26079112
23,6,2,0,6,14,2611894.26218661,4926962.96984246
20,6,1,0,5,12,2125264.53042362,6540511.77377158
15,2,1,0,6,9,2266215.48801615,5369525.06936154
36,0,3,1,5,9,1393360.2321364,4979158.86680312
35,2,1,0,1,4,1264842.56701287,3342194.99930821
11,5,1,2,7,15,2405689.04841517,6790414.80251116
22,5,1,1,5,12,2224011.31844871,7380186.50503667
39,3,0,2,0,5,1501395.02097177,4054309.31878168
40,6,2,0,1,9,1628627.27666419,5317050.64006225
26,5,2,0,1,8,1552880.18480839,5756368.88436578
37,1,3,2,7,13,2431120.62216028,8514618.18264718
32,4,1,1,2,8,1519739.308902,3967977.45029387
16,1,3,1,0,5,1540540.60998012,1984334.40629544
31,0,2,1,0,3,974669.455329731,4063821.90139296
13,5,1,0,7,13,2242136.4402229,8125257.81952121
36,5,0,0,0,5,1381764.23113886,4640853.55749795
32,3,3,0,7,13,2234102.6998102996,8805546.43629937
23,4,1,0,7,12,2266046.48409732,8458933.17646805
30,6,3,1,1,11,2478664.35393734,5828070.65628804
35,6,1,1,7,15,2883093.13175821,9220892.62929482
31,4,0,0,4,8,2007149.4022985,5821556.48032217
37,3,0,1,0,4,1311116.81043987,3449230.8663363
28,2,3,0,4,9,2337297.47400652,4889778.56458514
32,4,1,1,3,9,1623355.37121655,8592560.27819079
38,0,2,1,4,7,1415406.45475038,1325255.59983097
24,5,2,0,6,13,2417688.50307573,4592455.47434334
14,1,3,0,5,9,1217968.08374618,6228261.98970988
40,2,3,1,1,7,1746807.48605151,5118584.75278005
23,1,0,0,3,4,1695343.87654119,4848877.64145669
14,3,1,1,3,8,1988451.94337816,9792354.0537447
11,0,2,2,1,5,1771907.31479671,7321264.37135715
29,5,3,1,5,14,2978563.83654088,6155445.01995307
29,1,0,0,5,6,1674155.25850321,3346235.55323333
29,4,1,2,4,11,2328024.00439039,6638436.2405598
40,1,2,1,1,5,1399092.65952152,4629711.03057851
20,1,1,0,1,3,965853.549220791,4074849.1396166002
32,2,1,1,5,9,1949088.73930672,8129000.91177665
31,4,3,2,1,10,1884247.04629399,4831396.31077386
11,6,3,2,7,18,3188401.59837655,10752305.660285
31,5,0,0,4,9,2030812.97856098,3893481.71169203
33,3,1,2,6,12,2233755.72925166,6011055.79314848
15,3,1,2,3,9,1556134.74628928,11191380.1232589
22,2,0,0,6,8,1711009.66461299,6901762.48051979
25,2,1,2,4,9,1554492.92189273,5428979.88021267
28,2,1,2,3,8,1996186.12583564,5064908.61060302
30,6,3,1,3,13,1947928.66730488,9722669.83717212
25,0,0,0,3,3,1015388.90093081,2860666.64924011
28,5,3,0,7,15,2336206.64050246,3175635.25585903
20,0,1,2,4,7,1230014.45457014,7120445.66204302
12,2,0,2,2,6,1385277.15144625,8079034.135955
19,3,1,0,7,11,2246711.00136409,4318821.95048686
17,0,0,2,1,3,1306248.81190233,3799574.38733739
14,0,3,2,1,6,1818753.78868984,2555055.1509817
23,3,1,2,1,7,1674318.76173643,3770951.41078524
27,6,3,0,4,13,1988114.35165229,8629896.63322078
30,1,3,0,1,5,1841034.86414537,3425740.10562157
10,0,1,1,0,2,1476262.58551302,3898379.53806515
23,4,0,1,4,9,1856310.31532103,7193978.1233272
23,0,2,1,0,3,1143597.49026312,4188646.30493589
21,2,1,0,5,8,1472278.20138679,1591564.12539509
31,4,1,2,3,10,949824.7393671891,6180394.77935043
15,6,3,2,6,17,2124460.4245531,6626404.05897761
38,5,2,0,1,8,2000942.19562356,4232335.695289
21,1,0,2,0,3,1078476.58753621,2410672.2785046003
11,2,2,2,5,11,1793046.29024196,6318549.96983487
34,1,3,1,4,9,2241300.71256943,4433128.40925931
38,4,2,2,3,11,2344025.98816297,6232973.47669251
22,5,2,0,1,8,1995051.38175365,5601632.51840065
27,5,2,0,4,11,2088211.14720283,6801867.68682873
32,4,0,2,6,12,1953190.45153731,5317486.43641858
16,6,2,2,6,16,2501153.18862743,6277996.00863383
38,6,2,2,6,16,3218984.72012886,9878063.29477188
20,2,0,1,2,5,1703274.70249276,5724384.13741283
34,5,3,2,1,11,2985189.57074258,4480810.10996385
10,0,3,1,5,9,1502728.20866329,3790058.90665084
33,2,1,0,4,7,1718251.69045101,3092820.93864714
33,2,0,0,4,6,1590170.62402853,5576794.554217299
23,4,2,2,6,14,2133922.07758298,7966124.30242957
40,6,2,2,7,17,2650344.15036734,10001924.7637038
16,3,2,2,2,9,2839427.57405415,3018475.66847871
15,2,0,0,5,7,1647700.37379119,7061130.75924315
22,0,0,0,7,7,1811019.83731527,6644709.60067204
34,2,1,0,0,3,1369346.76577077,4160776.03905881
15,4,3,0,2,9,2038424.98974059,5005317.38256235
32,6,2,0,4,12,1891675.46535665,5166215.91787813
36,2,2,0,3,7,1678333.83981947,6615617.871334201
34,4,1,0,0,5,1876361.75305853,2413403.60619393
36,2,3,2,0,7,1762870.95153332,4591502.01830144
11,6,0,2,3,11,1496921.90036487,4032581.71092486
38,1,0,2,2,5,2006408.97399048,1284158.57588479
22,3,0,0,6,9,1789350.96142262,5324024.43830822
35,5,1,0,7,13,2718325.80551267,6437601.67509123
39,4,2,1,4,11,2394543.01634228,6153569.62766122
31,2,0,1,4,7,1626846.81486706,5649679.37159206
34,5,2,1,4,12,2275404.82036516,7020529.92594801
25,3,2,0,1,6,1342558.36404207,4826652.51883102
30,5,1,2,1,9,1813723.33638933,6245838.72063706
19,6,0,2,2,10,2385197.15050661,6971104.1592231
11,6,1,0,3,10,1932203.69295299,5853782.59326048
37,0,1,1,7,9,1802597.35393535,7149281.41740779
40,4,0,0,5,9,1720605.27715376,6703649.96451846
25,5,3,2,2,12,2168097.90132056,7731997.53715973
27,1,3,0,4,8,1974214.27118313,2133994.94009341
26,4,3,1,0,8,1503476.61318555,5876416.1605365
24,0,2,0,3,5,1441818.56720639,5331108.19665073
16,5,3,2,2,12,2460065.32549661,5115151.42650882
19,2,2,2,3,9,2057705.96125377,6185710.49623652
23,4,0,1,3,8,2155751.26292753,2271998.95354662
17,4,3,1,3,11,1937384.19366043,5021473.37063137
31,4,0,2,3,9,1777530.93283025,5239646.29180602
24,3,3,2,1,9,1686947.28489992,7328662.01362361
16,3,3,2,4,12,1835036.70522507,10353883.024171902
24,1,2,0,5,8,2204083.58052658,4457961.08822922
29,3,2,2,1,8,1563322.41890718,5372758.24541341
16,5,0,0,4,9,2133933.69489199,4957502.51887027
14,0,0,2,7,9,1796137.81107453,5695600.33286839
17,1,2,1,4,8,1766308.28770012,2117131.26180663
37,0,1,2,5,8,1318132.18683355,4891667.02699486
15,1,3,1,3,8,1958440.91862299,5156849.24571377
30,0,2,2,7,11,2552178.06458175,6540576.14441692
10,1,0,0,6,7,1570414.52269032,2888211.35339988
36,2,2,1,4,9,1921795.9673346002,7854994.55100881
28,5,3,2,1,11,2013356.43827571,3450495.92681539
10,4,3,2,6,15,2582186.8510078,4941516.50579302
28,3,1,2,3,9,1723310.48022203,5767400.40902071
18,2,0,0,4,6,1458834.70026094,5594811.14798415
16,6,3,0,7,16,2983293.85927968,6319276.99892039
23,6,3,2,0,11,2079085.75055387,9607911.61915308
27,1,0,2,3,6,1276342.29214665,5140169.96231069
34,5,0,1,2,8,1658722.62671393,5541146.48555068
18,4,0,0,3,7,1884937.3707675,8213603.9925132
38,3,0,2,3,8,1714809.58909014,4183465.4969728994
28,1,3,2,3,9,2003662.00122845,4658277.42979072
22,6,3,0,0,9,1786339.67057489,6922143.62596806
29,0,0,0,4,4,1619640.8331325,4567741.05943414
10,1,1,1,0,3,1366829.58195311,2875366.21219447
23,6,1,1,0,8,1388515.02890759,4506929.01417902
31,2,0,0,1,3,1344363.45803009,2841817.67397767
22,3,3,0,3,9,1639860.76537895,4820899.30840876
27,6,0,2,2,10,1691483.60622489,2341195.47893679
17,2,1,1,6,10,1466652.01620772,6852915.86366183
39,4,1,2,2,9,1241260.51649661,3007986.1051411
35,1,1,0,0,2,1188651.96336531,2825577.59192824
24,2,3,0,6,11,1776192.25421825,6598746.57089588
31,6,2,2,3,13,1629620.4658724,4908275.682582
12,3,0,1,2,6,1618699.23890674,3429226.51872794
23,5,2,1,1,9,1823857.14334382,4286644.36937783
23,4,1,1,3,9,1389233.33657507,7058466.14001872
27,1,0,1,6,8,1560704.33273567,5358177.17445042
16,6,2,1,2,11,2148628.68388459,6214072.44910066
10,6,1,2,3,12,2422858.3108628998,6328436.95688753
11,3,3,0,3,9,1701441.90584532,5842732.57478284
30,3,0,0,5,8,1582980.41981181,5279707.55625684
10,3,1,0,0,4,1244327.79810121,7749243.10061008
39,4,2,2,7,15,3822087.65945709,7488301.41202683
29,1,0,1,6,8,1821155.12164622,8728865.36384733
40,1,0,0,5,6,1569161.59120301,4428963.58044048
19,3,3,2,6,14,2289211.24391347,6761555.27451278
25,6,2,2,0,10,1767369.47109549,5434708.33110047
36,0,2,0,4,6,1667408.62159992,4468832.04641754
17,5,3,1,2,11,2245803.70472173,4744064.31708434
28,0,1,1,2,4,1534254.3266891001,2246112.76464826
38,3,2,2,1,8,1994999.09790916,6077460.91981027
32,5,1,2,3,11,2263499.11753317,5134611.80053072
12,5,3,2,4,14,2834163.4246839,6583305.55829664
18,4,1,0,2,7,1293132.16309401,5885907.3912472
38,0,1,2,1,4,1536595.4580893998,1692659.79317325
26,1,2,2,4,9,1678426.28200699,3362723.67775185
32,2,0,1,3,6,1469001.46414989,4769181.71802733
25,6,0,2,7,15,2427856.41042162,8813990.82279628
17,2,0,0,2,4,1315806.14361655,7771146.97366895
12,3,1,2,3,9,1684514.3135793002,6754543.56430208
21,6,3,2,2,13,2442714.04478704,8503290.65880893
16,1,2,1,7,11,1909783.41134132,7393346.00995242
36,5,1,1,0,7,1813303.18684487,4842102.859954
12,2,2,0,0,4,1223276.0242438999,6253665.69350113
36,1,2,1,0,4,1607277.24520966,4881492.05021964
35,4,0,2,5,11,1999291.99610396,7008767.44308474
26,3,3,1,6,13,1515134.69156099,4417359.03280101
24,0,2,0,0,2,1009134.26557856,3743408.81591303
23,6,2,1,0,9,2583127.30964283,6461399.73262355
29,2,2,2,1,7,1401043.43269453,6432672.36908105
34,3,1,2,6,12,2415526.3379834997,5262666.98127104
20,1,3,0,3,7,1693859.96419854,4765236.63664144
31,6,3,0,2,11,2085203.30068438,6427403.71833201
10,6,3,2,5,16,3018270.66209137,8104511.68670209
14,0,3,1,0,4,1223807.87180633,4498556.9356672
24,3,2,2,3,10,2221983.78920647,7577041.56816437
11,6,1,0,4,11,2272523.751028,3517049.979911
14,4,2,1,7,14,1976941.11398523,8268728.93054533
13,1,0,0,2,3,1256154.81644827,2395563.91140187
36,3,1,2,7,13,2241324.75207158,5731650.59572449
15,1,2,0,1,4,1743788.35617831,4732956.36840147
11,3,3,1,4,11,2190399.24269459,7308579.8191964
38,1,3,0,7,11,1672140.57407621,5539322.8757785
15,5,3,0,7,15,2310090.0846516,9468262.74791045
34,5,1,0,2,8,1782727.14323231,8900787.21209791
35,2,2,2,4,10,1518198.18197593,4648390.17107687
10,0,3,2,1,6,1428947.58923533,3005894.74027753
23,3,1,1,2,7,2062055.38642647,4710755.59560224
33,3,1,2,6,12,2138140.11459997,8276611.9829729
39,3,1,2,1,7,2100495.70690689,6159761.08203329
40,6,1,0,2,9,1512457.54039636,5963209.23129186
37,4,1,0,1,6,1804182.57533195,2970828.5225726003
21,4,3,0,1,8,1527951.69848532,3246807.4134066002
24,3,0,0,3,6,1440336.59893182,1195060.88432434
14,2,2,0,0,4,1122078.48065562,4106668.48925719
38,2,0,1,5,8,1969228.60897628,4387499.32817579
14,2,3,1,7,13,2726416.67457534,6172190.04675107
16,2,2,2,1,7,1463083.77547897,6899430.69273884
34,1,1,2,1,5,1144361.63815511,8607102.21631883
37,3,3,1,5,12,1789392.32688603,5407496.45144706
40,6,0,0,0,6,2020283.93856371,1824663.41258724
22,1,0,0,5,6,1468659.12857818,7459032.44254265
24,0,0,1,4,5,1559948.6694955,3180335.23898109
36,0,1,2,0,3,1053663.97320208,2425611.64829677
27,6,2,2,1,11,1444872.25893645,7699758.12590254
30,2,3,1,5,11,1793868.40423895,7712074.62074732
14,1,3,1,0,5,1326170.77547568,1814937.78531582
30,2,0,2,0,4,1745094.24304753,4078306.66779586
19,6,2,0,3,11,2264709.90556885,7705336.91655661
20,1,1,1,6,9,1799468.51892798,5437944.72847567
35,5,2,2,2,11,2401352.9774726,3096412.87887372
21,6,0,1,2,9,1941491.07146692,8105622.85979324
18,6,1,2,7,16,3367234.20561596,10142804.5856414
11,4,1,2,3,10,2581386.57346933,6835603.74440037
18,6,1,0,5,12,2559771.61078912,6351476.07900697
25,5,0,0,3,8,1681864.32985657,6156134.264313299
39,1,3,2,2,8,1978651.19665949,3967393.18145361
24,5,3,1,6,15,2924882.91635034,4283068.49446587
26,6,1,2,5,14,3316040.27509265,3046655.07112171
10,1,1,0,2,4,976168.436255012,5152911.47451759
28,3,2,0,5,10,2099709.29130083,5886099.2155126
14,2,3,0,0,5,1573973.74771878,5539327.75476595
13,0,3,1,2,6,1389312.05198093,7242733.37739578
23,4,3,2,0,9,2206931.19445742,7165940.1674647005
29,0,3,2,2,7,1512520.51888216,5438665.63638605
16,5,3,0,2,10,1858701.70362347,4559019.15242683
38,4,3,1,4,12,1972799.68931306,7379103.288702701
30,2,3,2,4,11,2667466.22379812,6003154.22349243
40,1,1,2,3,7,1531882.23309154,3851780.13267161
16,4,0,0,2,6,1810357.61355347,5186066.9485702
15,6,1,0,0,7,1204871.72029047,4693495.74925809
40,0,3,1,7,11,2388406.68924551,5775972.36330351
31,6,1,1,1,9,1735583.72638766,4250870.54015132
37,2,3,0,1,6,1756018.89055803,5945270.27277482
15,1,2,0,6,9,2015565.82445078,3259262.76134757
29,3,3,2,5,13,2361271.14704896,7245448.40295214
37,3,1,0,0,4,1045006.81309184,4941928.30032776
31,5,3,1,5,14,2170365.42519234,6900431.80489337
21,1,3,2,5,11,2658561.9194939,6740591.34640148
27,2,0,2,0,4,1718193.8252166,1290725.77989726
27,5,3,1,6,15,2965658.2397229997,7723917.02455238
40,6,2,0,7,15,2554494.27246656,10298367.0897869
12,3,2,0,1,6,1696713.73154751,5252996.46798044
32,1,3,1,1,6,1639564.79713328,4009269.12646285
38,0,1,1,4,6,1424289.64178113,4724666.80721394
15,2,1,0,6,9,1993841.52197163,4336070.82234482
32,5,1,2,6,14,1911352.44986149,10893419.007587599
38,5,1,1,1,8,2339813.31875431,5432715.41100963
40,3,0,1,0,4,1394581.65571958,3048670.69215061
34,0,2,1,6,9,1928649.49286476,6726791.65982667
24,5,1,1,1,8,1682936.06242079,7729667.97060343
24,5,1,2,0,8,2062730.02882025,4157302.53308263
26,0,1,0,1,2,1303488.94021996,3653394.71832087
21,6,1,0,3,10,1682895.49581061,2803340.44185389
17,3,3,0,2,8,1540913.50613864,7081216.74727455
20,0,0,1,7,8,1898672.54831612,5968391.46334801
22,5,2,0,1,8,1412734.35227546,5418527.44024933
38,5,3,1,2,11,1929580.61856399,4743195.75968851
35,4,2,1,4,11,2365909.88306558,6642602.04221077
40,4,0,2,6,12,2402962.80079076,9399010.53162345
15,6,1,1,7,15,2790482.19053982,7184743.98709264
40,4,3,1,1,9,1130753.18971122,8234510.97337107
21,2,0,1,7,10,1678809.28659364,6344390.52457292
10,3,3,1,2,9,1768016.88238876,5613941.08806866
32,3,0,2,4,9,1150288.0924258002,8839874.64020867
14,6,0,0,5,11,1945456.69997093,7608879.09939536
39,0,2,0,5,7,1588864.54231421,4424067.34847845
18,3,3,1,7,14,2507708.52158063,8678747.54822109
25,0,2,2,4,8,2223875.40363531,5179179.4194845995
34,6,2,1,6,15,1910673.33870127,8554024.43675522
19,1,1,2,3,7,1691008.18598953,7732474.21198216
30,0,0,1,1,2,1347391.26764964,6425507.27109296
22,6,1,2,0,9,2490818.06282624,5134164.91570661
18,0,0,2,1,3,1581751.12512451,2712571.71696586
28,5,1,2,4,12,2709403.19233588,8140232.39127782
19,1,2,1,4,8,2131793.90383459,7228994.39820857
15,3,1,0,6,10,1941005.40331268,5949234.25758988
25,1,3,0,6,10,1996591.10837974,4590301.72301068
19,2,0,2,5,9,2170577.39370717,3878847.32648123
28,5,0,0,0,5,1406556.64338523,5972182.44268178
31,6,0,0,3,9,2213033.43623234,6298000.14687728
39,2,0,1,1,4,1486288.54345347,4229272.84481129
17,6,2,1,7,16,2035324.18536519,7114115.71029619
36,3,1,1,4,9,1780609.83423438,4448876.76887436
30,1,2,1,6,10,2098761.57359483,6744018.26375717
10,1,2,2,3,8,1770476.05916737,3470799.02591194
10,2,2,0,6,10,2160095.64918647,6005895.20403019
25,5,2,2,5,14,2386853.87535219,8213522.34930765
33,5,2,0,3,10,2162002.98993293,3859147.56696897
10,5,1,0,4,10,2403242.92839567,4973901.92863549
10,2,1,0,4,7,1957272.32139861,2371725.56840419
26,0,2,1,3,6,1702707.2867558,6041718.48887808
24,3,2,2,4,11,2155171.17148707,7745116.70238795
19,3,1,0,4,8,1593935.5147998,3461482.17722644
22,1,1,1,0,3,1249093.78078179,5958448.4421441
33,3,3,1,7,14,2370908.19296849,6427237.5670868
30,4,2,1,7,14,1741935.57397963,5340194.70785663
12,5,2,0,1,8,1429261.81034924,4465327.73495127
17,2,3,2,1,8,1862109.32516491,5083067.55762953
27,1,1,2,0,4,1614371.17009418,3795238.57598297
24,0,0,2,3,5,1252445.03921541,4048830.56204295
28,1,1,1,0,3,1732218.53548484,4171184.37597154
19,1,1,1,3,6,1721708.48765525,5049092.63256031
21,6,1,2,2,11,2290684.16788505,8000529.82616989
35,2,0,0,7,9,2364431.32062754,5597366.41027934
36,2,0,2,0,4,1497178.91850379,5760691.37554589
24,5,2,2,3,12,2223655.05260425,4223784.92951913
14,2,0,0,2,4,1448242.43332381,7686632.51711834
23,5,3,1,2,11,2273328.29424056,9919131.49174475
37,0,1,0,6,7,1374663.45728304,3829476.11253596
16,5,1,1,0,7,1961881.89126014,7395218.14782742
21,3,2,1,6,12,2189935.98526632,8486200.26838055
24,5,1,0,7,13,2009174.17283383,3566745.27044823
24,0,0,1,2,3,1246423.38690152,1476687.50270438
34,6,2,0,6,14,2991218.10128057,7429059.268101401
14,4,1,1,5,11,3197265.5867966,7348527.61196114
12,0,2,2,3,7,2072713.24608377,4414253.38653184
29,0,0,2,5,7,1747896.67047075,2809268.84318116
38,4,3,1,6,14,2782014.54075778,3992864.45423971
18,1,1,0,7,9,1646248.17086613,5069074.16923657
40,2,1,1,7,11,1826075.33547198,9520547.71294656
21,0,0,0,4,4,1606368.99599257,3146975.79077855
18,1,1,2,6,10,2020483.32151867,4137943.41512079
26,1,3,0,2,6,1453827.22932104,4431018.87753709
14,5,2,1,6,14,2284904.32255988,9583087.48697646
22,6,2,1,4,13,2514992.46556653,5833613.44220025
40,4,3,2,7,16,3226865.13206493,6936396.82597292
34,5,3,1,2,11,2036760.30101457,3785769.91992072
13,1,3,1,7,12,2435759.80003185,6101810.96523757
38,0,3,1,3,7,1536268.04188495,8236851.42810053
25,3,3,2,5,13,1860390.0334885,8195975.32481736
28,5,2,0,7,14,2708176.46672132,4761940.77516722
29,0,3,2,4,9,1864650.33159635,6850964.02693064
31,5,3,0,5,13,2243090.70994923,7247989.89245514
17,0,3,1,3,7,1483196.49116972,2760991.49552706
33,5,2,1,4,12,1984610.27815526,7254692.25386221
30,0,1,0,4,5,1651088.08099653,3504236.48645601
29,2,2,0,6,10,2126180.73287621,6521022.45589533
20,2,1,2,3,8,1592185.01315857,7545333.44265734
29,6,3,0,2,11,2099650.6863636,8412463.54294972
32,0,3,2,3,8,1692565.48899464,2991493.31273292
36,0,3,2,4,9,1431209.12780972,8603835.08944416
22,1,3,1,2,7,1562483.28713893,4084324.76620905
21,2,0,2,6,10,1903499.67157367,9184691.093539698
20,3,0,1,3,7,2155388.32525386,9395851.65234265
31,6,0,1,2,9,1389266.2603522,6267899.71996526
31,5,2,2,6,15,2560854.94843976,6465435.704191599
23,4,0,2,6,12,2272729.95938884,7354658.90205167
31,2,1,0,6,9,2029475.63663233,8573988.27591617
40,5,3,0,1,9,2003064.18703508,4805530.30539067
31,1,3,2,0,6,1723232.18066549,5279054.63654499
26,0,3,2,2,7,1386728.33059922,3844630.66711007
29,5,0,1,5,11,2612661.59751682,7067579.71471232
14,4,3,0,6,13,2060225.75544666,7105605.87610477
24,3,0,2,5,10,1993990.26463617,3889623.90004068
30,6,3,0,1,10,1583225.24056392,6114097.92298334
18,6,0,1,6,13,2803361.20370427,4929858.21697504
18,3,2,0,5,10,1319653.04893912,6019772.6617167
36,0,3,0,2,5,1534712.22700647,5448036.86265319
35,2,3,1,1,7,1306502.8779028,2255186.92892763
22,6,3,2,2,13,2198470.17838814,5638224.37980247
15,3,2,2,1,8,1843109.16358316,5167108.93039634
22,3,0,2,4,9,1564038.74830778,6522591.81604967
20,5,0,2,6,13,1934616.70731286,9365465.03128925
40,5,3,1,5,14,2858972.28276609,7924446.30064815
36,2,3,0,3,8,2095790.23784742,3268618.68378143
13,3,0,0,1,4,1036932.81669891,4572684.74748043
37,3,3,0,6,12,2078774.44035331,6406104.05499092
11,6,1,1,4,12,2323543.21964093,3414226.28588883
27,1,1,2,3,7,1822184.28579332,2958660.28354973
18,2,0,0,1,3,1191869.92533839,2735171.19738253
26,5,3,0,6,14,2026400.14431966,9009863.32573243
36,6,1,2,2,11,2042545.73215175,7620438.60270771
25,5,0,0,1,6,1612737.82715077,4937257.65743055
24,5,2,0,6,13,1812028.30990012,6714730.59851635
30,2,2,1,3,8,2149127.38463745,4353394.87797891
34,5,3,2,4,14,2668364.37221578,3078683.91550947
15,2,3,1,5,11,1565208.71457046,9039572.497422501
21,3,3,1,1,8,1375995.03783111,3949111.25652249
36,5,0,2,6,13,2374222.39937453,8616801.44381503
13,3,1,0,2,6,1079952.98131196,5821389.78483041
14,5,2,1,3,11,2326626.58404379,3826620.01210531
12,6,2,1,7,16,3175108.40094763,1335943.94916575
37,0,3,2,6,11,2174590.07015588,6823516.925034901
10,5,0,1,4,10,2458441.54595553,7881175.7699323
28,2,1,1,3,7,1854867.67535453,7018086.10810435
15,2,3,1,6,12,2087490.20786233,6462714.25537833
33,6,1,1,1,9,2133513.65306298,3097683.13440099
33,3,2,1,1,7,1616092.02153371,5681404.84100857
13,0,1,2,2,5,1308581.77523047,5587224.07416334
11,1,2,2,1,6,1847586.07334734,4072914.35463861
25,1,2,0,7,10,2175058.22884121,5114660.92945527
24,2,1,2,5,10,1863618.48847677,6315314.34741442
33,2,2,1,3,8,1258175.99959197,4540131.53596844
40,1,3,1,2,7,1403254.49353661,4534194.95551432
10,0,0,2,7,9,1925756.05262184,3313351.40957964
33,3,3,0,3,9,2069499.31051009,5905997.12449219
37,6,2,0,0,8,1287713.2724191002,3754086.13592972
19,6,0,2,0,8,1741627.07572051,6372983.09394557
30,2,0,2,4,8,2114625.04518,7336434.60286651
38,5,3,1,1,10,2235900.26579788,5510824.67192837
17,2,1,0,7,10,1980801.39460441,3247877.85493788
18,3,3,1,4,11,1741437.94844826,4225084.725174201
27,3,3,1,3,10,1794459.40974003,4608522.30527276
39,4,0,1,6,11,2135872.87181307,8457019.35517662
29,0,0,2,1,3,1254651.24236983,1922031.49571311
17,4,3,2,5,14,2042517.74270747,8469758.44287077
12,5,2,1,2,10,2299062.52467173,4415845.46311731
15,4,2,2,6,14,1819887.74804737,7559397.40943743
31,1,0,0,6,7,1994824.17534581,1681154.74026274
12,3,0,2,2,7,1816722.61240066,3399697.32778617
14,6,0,2,3,11,2565833.76898725,9154901.40552078
33,2,0,0,1,3,1504410.67356099,1759309.7519200002
31,0,0,1,5,6,1332340.11484931,2071505.33477563
25,0,2,1,2,5,1560487.36131028,3830650.74538823
29,6,1,1,1,9,2006183.37364588,2337987.73383053
18,0,2,1,6,9,1867785.12014071,4928375.02586169
38,6,2,0,5,13,2333729.33880801,3601963.08119072
29,1,0,0,2,3,1528513.32850011,2988197.65652993
18,5,3,1,7,16,2826293.83841034,6535751.37388816
12,1,1,2,7,11,2566197.44881461,7985985.56200567
23,1,0,2,5,8,2251426.20583817,4506246.8095069
23,6,2,0,2,10,2347784.49932479,7677756.35973534
18,1,1,0,7,9,1821954.99391314,3983257.29487356
35,2,0,1,2,5,1265306.16188659,2211129.99518298
25,1,0,1,7,9,1583733.59007394,5407996.46176456
23,6,3,2,3,14,2446515.64057667,9154445.28660263
12,0,0,2,2,4,1520955.27484739,2451947.06089715
25,6,1,0,5,12,2027525.66008932,6092739.63432949
17,2,2,1,0,5,1768830.82230005,2332011.81241056
37,5,0,2,2,9,1946480.0647871003,7720322.18719141
39,5,2,1,7,15,3194438.9488705,8788039.99439083
12,1,2,1,5,9,1764874.04479241,1676467.0114796
16,2,1,2,1,6,1326697.99388252,4049289.22166983
34,6,3,1,6,16,3092503.95392911,11236465.7589803
24,6,2,2,7,17,2551442.2693201,9838118.43135711
17,0,1,1,5,7,2137766.82296653,2640070.43725309
36,0,3,0,6,9,1230262.14698227,3176084.05702444
26,4,0,1,5,10,1705176.33314331,5197865.57938204
25,0,2,1,4,7,1994162.69110113,7617304.59683182
23,5,2,1,5,13,2315558.45377607,6270058.1638315
37,1,2,1,7,11,2397164.71159265,3286609.92240945
14,1,1,0,1,3,1309276.42178469,1829591.76123189
32,6,3,2,5,16,2449189.04222399,9087545.75500466
24,6,2,0,7,15,1845785.22300564,6098951.51907906
24,3,0,1,2,6,1085134.3612948,4390434.39734313
38,4,0,0,6,10,1468680.75016369,7341915.86871898
13,1,0,0,2,3,1451737.77979372,1851022.70952206
38,6,3,2,4,15,2261493.2542438,6216297.78257355
40,1,2,0,3,6,1981125.03876799,2409946.9159461004
20,5,2,1,5,13,2754291.6115342,9494292.24131104
12,6,1,0,0,7,1554076.45350008,4920757.01407727
38,1,0,1,3,5,1273641.80043229,7332738.9837947
37,1,3,2,5,11,1878010.45601532,6609702.81504245
33,3,0,0,5,8,1965206.28271173,2865299.78139209
13,3,3,1,3,10,2220847.86311796,3014932.16060238
24,5,0,0,3,8,1968972.89710892,5750881.14077143
40,4,1,2,4,11,2161615.98082908,6151803.53663273
15,4,3,1,1,9,1691506.4651558,8025741.513559
20,4,1,0,3,8,1213571.82279945,4955391.14047561
38,4,0,2,5,11,1970422.97368183,6775761.10263736
29,2,1,1,3,7,1221259.04905389,5097826.92623032
22,2,0,2,3,7,1807689.6919957001,5373143.09396687
33,5,3,1,7,16,1915413.11963215,7356236.01703002
20,6,3,0,5,14,2532052.3810174,5883387.24838624
20,0,3,2,5,10,2301717.08540761,5763385.56388349
32,1,1,2,7,11,1881437.76950546,8798870.27220093
31,5,3,1,6,15,3147492.18498743,8101750.52787014
13,5,3,0,3,11,1782555.47541067,4993851.7534122
26,6,1,1,4,12,2265052.7802244998,5862359.14127492
40,5,1,0,4,10,2117377.42002033,6557979.66440298
35,5,0,0,6,11,2415985.61845219,5594641.598351
30,1,0,0,7,8,1918885.71762499,3856948.40246474
15,2,1,0,3,6,1340926.78608801,7257617.87008351
10,3,1,2,3,9,2132042.13901575,7554062.19126575
28,3,3,2,5,13,2965625.06925077,3360763.16413102
39,0,1,0,0,1,1366992.89574573,3826536.36594786
12,1,1,2,2,6,1489493.72278205,4401577.59284356
36,5,0,2,1,8,1457867.98046072,3919234.38645066
19,1,1,0,4,6,1487641.77331976,6368936.54263309
20,2,3,2,7,14,2016757.93774839,8096647.62118044
25,0,0,0,5,5,1594179.57335298,5219315.56051676
27,4,3,1,0,8,1967352.78840168,5967845.71893728
31,0,1,0,0,1,988189.084778907,3203669.05984306
27,4,3,2,2,11,2033501.38361248,6356874.95081936
12,4,0,2,2,8,2048616.24264349,6417860.48743898
25,4,3,1,6,14,2546224.33650556,7953816.78287663
28,1,3,1,5,10,1714715.70943001,4033157.81559409
15,2,3,2,0,7,1721550.00386034,6988304.70286272
31,4,0,0,5,9,2163108.3195929,8177613.50737278
32,5,0,1,6,12,2858949.64194508,5150422.77240458
12,2,1,1,2,6,1639146.2574546998,2913650.33400506
34,2,1,0,4,7,1708502.4383988,6762698.69119132
20,0,0,2,2,4,1447118.50811377,6824523.51805208
10,0,2,1,2,5,1552397.32401533,3110037.01884973
32,5,3,1,2,11,2157835.89745889,4490956.33814582
22,4,1,0,1,6,1931115.92623054,4993035.37251163
18,3,0,1,6,10,2128822.14631259,3956001.92117428
10,3,0,0,7,10,2754858.23671691,5443493.58315418
12,4,2,2,0,8,2164925.37465641,7174518.32853763
24,2,3,1,2,8,1346541.30455624,6331991.8094437
37,2,0,1,7,10,1843815.04809812,7393643.49235252
24,6,3,1,0,10,1550213.99484526,6816851.10542291
27,5,3,0,3,11,2343854.92223856,5665339.82183499
28,1,0,0,7,8,1648129.08131758,4811272.51502021
10,3,0,0,2,5,1332679.80880011,5190546.43338788
32,5,1,2,0,8,2212703.62112343,5276369.87892226
33,4,0,0,3,7,1371566.67439634,3419459.93362904
21,3,3,1,7,14,2168962.61444618,1560902.22716813
20,6,0,1,5,12,1727811.81153492,6001207.26647679
27,5,2,1,6,14,2795228.16530013,8306028.119552901
23,0,1,1,3,5,1296284.17854643,5538311.33682689
